рте : ["особенно","особенно в"]
рте особенно : ["в"]
ругавшихся : ["дрогалей","дрогалей закутанных"]
ругавшихся дрогалей : ["закутанных"]
руках : ["на","на запотевших"]
руках на : ["запотевших"]
руками : ["и","и той"]
руками и : ["той"]
рыбачьих : ["баркасов","баркасов заблудилось"]
рыбачьих баркасов : ["заблудилось"]
рыбаков : ["в","в разных"]
рыбаков в : ["разных"]
рискованному : ["флирту","флирту во"]
рискованному флирту : ["во"]
роскошной : ["любви","любви и"]
роскошной любви : ["и"]
рогожи : []
род : ["которого","которого восходил"]
род которого : ["восходил"]
родила : ["от","от него"]
родила от : ["него"]
родовое : ["имение","имение было"]
родовое имение : ["было"]
розы : ["но","но уже"]
розы но : ["уже"]
розовые : ["кусты","кусты еще"]
розовые кусты : ["еще"]
роняли : ["желтые","желтые листья"]
роняли желтые : ["листья"]
рождением : ["молодого","молодого месяца"]
рождением молодого : ["месяца"]
рождались : ["и","и она"]
рождались и : ["она"]
рожка : []
ровно : ["ничего","ничего не"]
ровно ничего : ["не"]
решила : ["не","не иметь"]
решила не : ["иметь"]
редкие : ["точно","точно выродившиеся"]
редкие точно : ["выродившиеся"]
редкой : ["красоты","красоты спина"]
редкой красоты : ["спина"]
резко : ["и","и совсем"]
резко и : ["совсем"]
ремонтом : []
ревела : ["днем","днем и"]
ревела днем : ["и"]
расстроено : ["его","его предками"]
расстроено его : ["предками"]
расточительна : ["страшно","страшно любила"]
расточительна страшно : ["любила"]
расходами : []
распространяя : ["в","в чутком"]
распространяя в : ["чутком"]
распахнул : ["дверцу"]
раскачивались : ["пригибаясь","пригибаясь и"]
раскачивались пригибаясь : ["и"]
радостно : ["поцеловались"]
радовалась : ["наступившим","наступившим прелестным"]
радовалась наступившим : ["прелестным"]
раз : ["за","за это"]
раз за : ["это"]
разорения : []
разных : ["местах","местах берега"]
разных местах : ["берега"]
разноцветные : ["махровые","махровые гвоздики"]
разноцветные махровые : ["гвоздики"]
размякшему : ["шоссе","шоссе без"]
размякшему шоссе : ["без"]
разбитыми : ["стеклами","стеклами брошенными"]
разбитыми стеклами : ["брошенными"]
раннего : ["детства","детства были"]
раннего детства : ["были"]
рамы : ["хлопали","хлопали двери"]
рамы хлопали : ["двери"]
с : ["утра","северозапада","какимито","изуродованными","их","ремонтом","моря","прекрасными","ними","дачным","концами","сиденья","самого","гордостью","надменным","узенькими","довольно","завитыми","бледными","утра до","северозапада со","какимито утюгами","изуродованными клумбами","их внезапным","прекрасными серьгами","ними также","дачным временем","утра обещавшая","сиденья распахнул","самого раннего","гордостью называл","надменным выражением","узенькими глазами","довольно заметными","завитыми льняными","бледными мучнистыми"]
с сиденья : ["распахнул"]
с северозапада : ["со"]
с самого : ["раннего"]
с утра : ["до","обещавшая"]
с узенькими : ["глазами"]
с гордостью : ["называл"]
с прекрасными : ["серьгами"]
с довольно : ["заметными"]
с дачным : ["временем"]
с какимито : ["утюгами"]
с их : ["внезапным"]
с изуродованными : ["клумбами"]
с завитыми : ["льняными"]
с ними : ["также"]
с надменным : ["выражением"]
с бледными : ["мучнистыми"]
средств : []
срезала : ["ножницами","ножницами цветы"]
срезала ножницами : ["цветы"]
стручьях : ["пахнувших","пахнувших капустой"]
стручьях пахнувших : ["капустой"]
строго : ["проста","проста со"]
строго проста : ["со"]
страстная : ["любовь","любовь к"]
страстная любовь : ["к"]
страшно : ["любила","любила азартные"]
страшно любила : ["азартные"]
странных : ["противоречий"]
странного : ["не","не были"]
странного не : ["были"]
стульями : ["умывальниками","умывальниками самоварами"]
стульями умывальниками : ["самоварами"]
стороны : ["степи","степи свирепый"]
стороны степи : ["свирепый"]
столу : []
столицах : ["и","и на"]
столицах и : ["на"]
столик : ["футляр","футляр с"]
столик футляр : ["с"]
столетия : ["и","и древний"]
столетия и : ["древний"]
степи : ["свирепый","свирепый ураган"]
степи свирепый : ["ураган"]
стеклами : ["брошенными","брошенными собаками"]
стеклами брошенными : ["собаками"]
ста́ившихся : ["к","к отлету"]
ста́ившихся к : ["отлету"]
старинных : ["миниатюрах"]
старалась : ["помочь","помочь князю"]
старалась помочь : ["князю"]
суткам : ["тяжело","тяжело лежал"]
суткам тяжело : ["лежал"]
суд : []
сундуками : ["стульями","стульями умывальниками"]
сундуками стульями : ["умывальниками"]
схожи : ["между","между собою"]
схожи между : ["собою"]
счастливочудесного : []
спрыгнув : ["с","с сиденья"]
спрыгнув с : ["сиденья"]
спустя : ["неделю","неделю повыбрасывало"]
спустя неделю : ["повыбрасывало"]
спина : ["грудь","грудь и"]
спина грудь : ["и"]
сплошную : ["густую","густую грязь"]
сплошную густую : ["грязь"]
спокойна : []
спешным : ["делам","делам в"]
спешным делам : ["в"]
скулами : ["с","с узенькими"]
скулами с : ["узенькими"]
скарб : ["казавшийся","казавшийся таким"]
скарб казавшийся : ["таким"]
сквозь : ["мутную","мутную кисею"]
сквозь мутную : ["кисею"]
сирена : ["на","на маяке"]
сирена на : ["маяке"]
сипло : ["ругавшихся","ругавшихся дрогалей"]
сипло ругавшихся : ["дрогалей"]
сиденья : ["распахнул","распахнул дверцу"]
сиденья распахнул : ["дверцу"]
сидевших : ["на","на верху"]
сидевших на : ["верху"]
сильные : ["впечатления","впечатления острые"]
сильные впечатления : ["острые"]
сильно : ["монгольского","монгольского типа"]
сильно монгольского : ["типа"]
сильнее : ["чем","чем аристократическая"]
сильнее чем : ["аристократическая"]
силами : ["старалась","старалась помочь"]
силами старалась : ["помочь"]
слух : ["не","не обманул"]
слух не : ["обманул"]
слюдяным : ["блеском","блеском осенняя"]
слюдяным блеском : ["осенняя"]
слегка : ["выдвинутой","выдвинутой вперед"]
слегка выдвинутой : ["вперед"]
слабо : ["тянувшему","тянувшему с"]
слабо тянувшему : ["с"]
со : ["стороны","всеми","стороны степи","всеми холодно"]
со стороны : ["степи"]
со всеми : ["холодно"]
сором : ["из","из окурков"]
сором из : ["окурков"]
состояла : ["из","из веселой"]
состояла из : ["веселой"]
солнечные : ["и","и теплые"]
солнечные и : ["теплые"]
соленому : ["ветерку","ветерку слабо"]
соленому ветерку : ["слабо"]
сомнительные : ["кафе","кафе но"]
сомнительные кафе : ["но"]
собою : []
собаками : ["и","и всяческим"]
собаками и : ["всяческим"]
совсем : ["не","нежданно","расстроено","не вернулись","нежданно переменилась","расстроено его"]
совсем расстроено : ["его"]
совсем не : ["вернулись"]
совсем нежданно : ["переменилась"]
совпали : ["с","с дачным"]
совпали с : ["дачным"]
серьгами : ["из","из грушевидных"]
серьгами из : ["грушевидных"]
середине : ["августа","августа перед"]
середине августа : ["перед"]
сестры : ["несколько","всегда","несколько широкая","всегда приличных"]
сестры несколько : ["широкая"]
сестры всегда : ["приличных"]
сестре : ["принимать","принимать гостей"]
сестре принимать : ["гостей"]
сестра : ["княгини","княгини Веры"]
сестра княгини : ["Веры"]
сегодня : ["был","был день"]
сегодня был : ["день"]
сентября : ["погода","погода вдруг"]
сентября погода : ["вдруг"]
семена : ["будущей","будущей жизни"]
семена будущей : ["жизни"]
себе : ["и","и насколько"]
себе и : ["насколько"]
северозапада : ["со","со стороны"]
северозапада со : ["стороны"]
северному : ["побережью","побережью Черного"]
северному побережью : ["Черного"]
сжатых : ["полях","полях на"]
сжатых полях : ["на"]
сапогах : ["вздрагивали","вздрагивали оконные"]
сапогах вздрагивали : ["оконные"]
саду : ["и","и осторожно"]
саду и : ["осторожно"]
самых : ["близких","близких знакомых"]
самых близких : ["знакомых"]
самыми : ["небольшими","небольшими расходами"]
самыми небольшими : ["расходами"]
самого : ["раннего","Тамерлана","раннего детства","Тамерлана или"]
самого раннего : ["детства"]
самого Тамерлана : ["или"]
самому : ["рискованному","рискованному флирту"]
самому рискованному : ["флирту"]
самоварами : []
свысока : ["любезна","любезна независима"]
свысока любезна : ["независима"]
свирепый : ["ураган"]
сводил : ["концы","концы с"]
сводил концы : ["с"]
свое : ["видное","видное положение"]
свое видное : ["положение"]
своей : ["холодной","роскошной","высокой","холодной высокомерной","роскошной любви","высокой гибкой"]
своей роскошной : ["любви"]
своей холодной : ["высокомерной"]
своей высокой : ["гибкой"]
свойственны : ["северному","северному побережью"]
свойственны северному : ["побережью"]
трупы : ["рыбаков","рыбаков в"]
трупы рыбаков : ["в"]
трубах : []
тропинки : ["в","в сплошную"]
тропинки в : ["сплошную"]
третий : ["раз","раз за"]
третий раз : ["за"]
трехтонного : ["рожка"]
тратиться : ["на","на большой"]
тратиться на : ["большой"]
травянистый : ["грустный","грустный запах"]
травянистый грустный : ["запах"]
туман : ["и","и тогда"]
туман и : ["тогда"]
тюфяками : ["диванами","диванами сундуками"]
тюфяками диванами : ["сундуками"]
тянулись : ["ломовые","ломовые дроги"]
тянулись ломовые : ["дроги"]
тянувшему : ["с","с моря"]
тянувшему с : ["моря"]
тяжело : ["лежал","лежал над"]
тяжело лежал : ["над"]
тихие : ["безоблачные","безоблачные дни"]
тихие безоблачные : ["дни"]
тихо : ["осыпали","осыпали на"]
тихо осыпали : ["на"]
тишине : ["уединению","уединению чистому"]
тишине уединению : ["чистому"]
типа : ["с","с довольно"]
типа с : ["довольно"]
то : ["и","же","и дело","же время"]
то и : ["дело"]
то же : ["время"]
точно : ["бешеный","волны","выродившиеся","бешеный бык","волны в"]
точно бешеный : ["бык"]
точно волны : ["в"]
тогда : ["огромная","огромная сирена"]
тогда огромная : ["сирена"]
того : ["сегодня","сегодня был"]
того сегодня : ["был"]
только : ["спустя","самых","в","спустя неделю","самых близких","в начале"]
только спустя : ["неделю"]
только самых : ["близких"]
только в : ["начале"]
тонких : ["зеленых","зеленых стручьях"]
тонких зеленых : ["стручьях"]
тому : ["же","же по"]
тому же : ["по"]
той : ["очаровательной","очаровательной покатостью"]
той очаровательной : ["покатостью"]
товарищ : ["прокурора","прокурора живший"]
товарищ прокурора : ["живший"]
терпеть : ["не","не могла"]
терпеть не : ["могла"]
теплые : ["каких","каких не"]
теплые каких : ["не"]
теплой : ["и","и заботливой"]
теплой и : ["заботливой"]
теперь : ["она","она очень"]
теперь она : ["очень"]
телефону : ["приехать","приехать помочь"]
телефону приехать : ["помочь"]
телеграфных : ["проволоках","проволоках ласточек"]
телеграфных проволоках : ["ласточек"]
тем : ["лучше","лучше но"]
тем лучше : ["но"]
та : ["жадно","жадно хотела"]
та жадно : ["хотела"]
татарского : ["князя","князя дед"]
татарского князя : ["дед"]
так : ["свойственны","далее","свойственны северному"]
так свойственны : ["северному"]
таким : ["изношенным","изношенным грязным"]
таким изношенным : ["грязным"]
такие : ["ясные","ясные солнечные"]
такие ясные : ["солнечные"]
также : ["уехал","левкой","уехал в","левкой наполовину"]
также уехал : ["в"]
также левкой : ["наполовину"]
танцы : ["сильные","сильные впечатления"]
танцы сильные : ["впечатления"]
тайно : ["католичество"]
у : ["которой","дачных","нее","которой прежняя","дачных ворот","нее не","нее всегда"]
у дачных : ["ворот"]
у которой : ["прежняя"]
у нее : ["не","всегда"]
ураган : []
утром : ["по","по спешным"]
утром по : ["спешным"]
утра : ["шел","до","обещавшая","шел не","до утра","обещавшая по"]
утра шел : ["не"]
утра до : ["утра"]
утра обещавшая : ["по"]
утюгами : ["жестянками","жестянками и"]
утюгами жестянками : ["и"]
учреждении : ["и","и имел"]
учреждении и : ["имел"]
удержаться : ["от","от полного"]
удержаться от : ["полного"]
узенькими : ["глазами","глазами которые"]
узенькими глазами : ["которые"]
улыбке : ["может","может быть"]
улыбке может : ["быть"]
унаследовала : ["монгольскую","монгольскую кровь"]
унаследовала монгольскую : ["кровь"]
умывальниками : ["самоварами"]
уехал : ["в","в город"]
уехал в : ["город"]
уединению : ["чистому","чистому воздуху"]
уединению чистому : ["воздуху"]
уезжая : ["утром","утром по"]
уезжая утром : ["по"]
уже : ["перешла","измельчавшие","перешла в","измельчавшие редкие"]
уже перешла : ["в"]
уже измельчавшие : ["редкие"]
увязали : ["надолго","надолго возы"]
увязали надолго : ["возы"]
футляр : ["с","с прекрасными"]
футляр с : ["прекрасными"]
фигурой : ["нежным","нежным но"]
фигурой нежным : ["но"]
флирту : ["во","во всех"]
флирту во : ["всех"]
хлопали : ["двери","двери и"]
хлопали двери : ["и"]
хорошо : ["одеваться","одеваться держать"]
хорошо одеваться : ["держать"]
хорошеньких : ["малокровных","малокровных детей"]
хорошеньких малокровных : ["детей"]
хотя : ["довольно","довольно большими"]
хотя довольно : ["большими"]
хотела : ["детей","детей и"]
хотела детей : ["и"]
ходила : ["по","по саду"]
ходила по : ["саду"]
хозяйству : []
хозяйстве : []
холостой : ["брат","брат Николай"]
холостой брат : ["Николай"]
холодным : ["и","и гордым"]
холодным и : ["гордым"]
холодно : ["и","и немного"]
холодно и : ["немного"]
холодной : ["высокомерной","высокомерной красотою"]
холодной высокомерной : ["красотою"]
целым : ["суткам","суткам тяжело"]
целым суткам : ["тяжело"]
царственно : ["спокойна"]
цветы : ["к","после","к обеденному","после своей"]
цветы после : ["своей"]
цветы к : ["обеденному"]
цветах : ["а","а наполовину"]
цветах а : ["наполовину"]
цвели : ["своей","своей холодной"]
цвели своей : ["холодной"]
чрезмерного : ["обильного","обильного летнего"]
чрезмерного обильного : ["летнего"]
что : ["в","именины","под","в их","именины совпали","под низким"]
что под : ["низким"]
что именины : ["совпали"]
что в : ["их"]
чутком : ["воздухе","воздухе осенний"]
чутком воздухе : ["осенний"]
чувство : ["прочной","прочной верной"]
чувство прочной : ["верной"]
чувственном : ["рте","рте особенно"]
чувственном рте : ["особенно"]
чистому : ["воздуху","воздуху щебетанью"]
чистому воздуху : ["щебетанью"]
числился : ["при","при какомто"]
числился при : ["какомто"]
черт : ["может","может быть"]
черт может : ["быть"]
черепков : ["коробочек","коробочек и"]
черепков коробочек : ["и"]
чегото : ["счастливочудесного"]
человеком : ["который","который ровно"]
человеком который : ["ровно"]
чем : ["аристократическая","больше","аристократическая красота","больше тем"]
чем аристократическая : ["красота"]
чем больше : ["тем"]
частью : ["греки","греки и"]
частью греки : ["и"]
часто : ["нося","нося боками"]
часто нося : ["боками"]
чаще : ["и","и сильнее"]
чаще и : ["сильнее"]
широкая : ["в","в плечах"]
широкая в : ["плечах"]
шоссе : ["без","послышались","без конца","послышались знакомые"]
шоссе послышались : ["знакомые"]
шоссе без : ["конца"]
шофер : ["ловко","ловко спрыгнув"]
шофер ловко : ["спрыгнув"]
шел : ["не","не переставая"]
шел не : ["переставая"]
щурила : ["с","с надменным"]
щурила с : ["надменным"]
щетине : ["заблестела","заблестела слюдяным"]
щетине заблестела : ["слюдяным"]
щедрой : ["добротой","добротой и"]
щедрой добротой : ["и"]
щебетанью : ["на","на телеграфных"]
щебетанью на : ["телеграфных"]
это : ["лето","однако","лето бутоны","однако пленяло"]
это лето : ["бутоны"]
это однако : ["пленяло"]
этот : ["жалкий","день","подарок","жалкий скарб","день и","подарок еще"]
этот подарок : ["еще"]
этот день : ["и"]
этот жалкий : ["скарб"]
этого : ["великого","великого кровопийцу"]
этого великого : ["кровопийцу"]
экипажи : []
экономила : ["в","в домашнем"]
экономила в : ["домашнем"]
южане : ["поспешно","поспешно перебирались"]
южане поспешно : ["перебирались"]
ясные : ["солнечные","солнечные и"]
ясные солнечные : ["и"]
Анна : ["Николаевна","наоборот","вся","Николаевна Фриессе","наоборот унаследовала","вся состояла"]
Анна Николаевна : ["Фриессе"]
Анна наоборот : ["унаследовала"]
Анна вся : ["состояла"]
Близко : ["на","на шоссе"]
Близко на : ["шоссе"]
В : ["середине","городе","середине августа","городе пришлось"]
В середине : ["августа"]
В городе : ["пришлось"]
Веру : []
Веры : ["Анна","та","Анна Николаевна","та жадно"]
Веры та : ["жадно"]
Веры Анна : ["Николаевна"]
Вера : ["Николаевна","у","пошла","же","Николаевна Шеина","у которой","пошла в","же была"]
Вера у : ["которой"]
Вера Николаевна : ["Шеина"]
Вера пошла : ["в"]
Вера же : ["была"]
Доцветали : ["разноцветные","разноцветные махровые"]
Доцветали разноцветные : ["махровые"]
Еще : ["печальнее","печальнее было"]
Еще печальнее : ["было"]
Ее : ["холостой","грациозная","холостой брат","грациозная некрасивость"]
Ее холостой : ["брат"]
Ее грациозная : ["некрасивость"]
Европы : ["но","но никогда"]
Европы но : ["никогда"]
Жалко : ["и","и грустно"]
Жалко и : ["грустно"]
Зато : ["пышно","пышно цвели"]
Зато пышно : ["цвели"]
И : ["теперь","теперь она"]
И теперь : ["она"]
К : ["обеду","обеду муж"]
К обеду : ["муж"]
Кроме : ["того","того сегодня"]
Кроме того : ["сегодня"]
Клумбы : ["опустели","опустели и"]
Клумбы опустели : ["и"]
Княгиня : ["Вера","Вера Николаевна","Вера у"]
Княгиня Вера : ["Николаевна","у"]
Князь : ["Шеин","Шеин несмотря"]
Князь Шеин : ["несмотря"]
Лицо : ["ее","ее сильно"]
Лицо ее : ["сильно"]
ЛангТемира : ["как","как с"]
ЛангТемира как : ["с"]
Муж : ["уезжая","уезжая утром"]
Муж уезжая : ["утром"]
Мужа : ["она","она терпеть"]
Мужа она : ["терпеть"]
Младшая : ["Анна","Анна наоборот"]
Младшая Анна : ["наоборот"]
Николаевна : ["Шеина","Фриессе","Шеина жена","Фриессе с"]
Николаевна Фриессе : ["с"]
Николаевна Шеина : ["жена"]
Николай : ["товарищ","товарищ прокурора"]
Николай товарищ : ["прокурора"]
Но : ["к","к началу"]
Но к : ["началу"]
Несколько : ["рыбачьих","рыбачьих баркасов"]
Несколько рыбачьих : ["баркасов"]
На : ["обсохших","обсохших сжатых"]
На обсохших : ["сжатых"]
Остальные : ["цветы","цветы после"]
Остальные цветы : ["после"]
Отправляясь : ["на","на большие"]
Отправляясь на : ["большие"]
Огромное : ["родовое","родовое имение"]
Огромное родовое : ["имение"]
Они : ["с","с самого"]
Они с : ["самого"]
Она : ["была","во","пошла","охотно","была одна","во многом","пошла навстречу","была на","была замужем","охотно предавалась"]
Она пошла : ["навстречу"]
Она охотно : ["предавалась"]
Она была : ["одна","на","замужем"]
Она во : ["многом"]
Обитатели : ["пригородного","пригородного морского"]
Обитатели пригородного : ["морского"]
По : ["размякшему","милым","внешности","размякшему шоссе","милым отдаленным","внешности они"]
По размякшему : ["шоссе"]
По милым : ["отдаленным"]
По внешности : ["они"]
Сразу : ["наступили","наступили тихие"]
Сразу наступили : ["тихие"]
Старшая : ["Вера","Вера пошла"]
Старшая Вера : ["пошла"]
Сестры : ["радостно","радостно поцеловались"]
Сестры радостно : ["поцеловались"]
То : ["по","с","задувал","по целым","с утра","задувал с"]
То с : ["утра"]
То по : ["целым"]
То задувал : ["с"]
Тонкий : ["слух","слух не"]
Тонкий слух : ["не"]
Теперь : ["она","она ходила"]
Теперь она : ["ходила"]
Тамерлана : ["или","или ЛангТемира"]
Тамерлана или : ["ЛангТемира"]
У : ["нее","нее были"]
У нее : ["были"]
Успокоившиеся : ["деревья","деревья бесшумно"]
Успокоившиеся деревья : ["бесшумно"]
Фриессе : ["с","с утра"]
Фриессе с : ["утра"]
Хорошо : ["выходило","выходило что"]
Хорошо выходило : ["что"]
Что : ["касается","касается Веры"]
Что касается : ["Веры"]
Черного : ["моря"]
Через : ["несколько","несколько минут"]
Через несколько : ["минут"]
Шеин : ["несмотря","несмотря на"]
Шеин несмотря : ["на"]
Шеина : ["жена","жена предводителя"]
Шеина жена : ["предводителя"]
Это : ["подъезжала","подъезжала сестра"]
Это подъезжала : ["сестра"]
грустный : ["запах"]
грустно : ["и","и противно"]
грустно и : ["противно"]
грушевидных : ["жемчужин","жемчужин и"]
грушевидных жемчужин : ["и"]
грудь : ["и","и плечи"]
грудь и : ["плечи"]
грязь : ["в","в которой"]
грязь в : ["которой"]
грязным : ["и","и нищенским"]
грязным и : ["нищенским"]
греки : ["и","и евреи"]
греки и : ["евреи"]
гремели : ["по","по ночам"]
гремели по : ["ночам"]
грациозная : ["некрасивость","некрасивость возбуждала"]
грациозная некрасивость : ["возбуждала"]
границей : ["сомнительные","сомнительные кафе"]
границей сомнительные : ["кафе"]
густую : ["грязь","грязь в"]
густую грязь : ["в"]
густой : ["туман","туман и"]
густой туман : ["и"]
губе : ["лицо","лицо это"]
губе лицо : ["это"]
гибкой : ["фигурой","фигурой нежным"]
гибкой фигурой : ["нежным"]
глупым : ["человеком","человеком который"]
глупым человеком : ["который"]
глубокой : ["женственности","искренней","женственности всех","искренней набожностью"]
глубокой искренней : ["набожностью"]
глубокой женственности : ["всех"]
глядеть : ["сквозь","сквозь мутную"]
глядеть сквозь : ["мутную"]
глинистые : ["дороги","дороги и"]
глинистые дороги : ["и"]
глаза : ["и","и за"]
глаза и : ["за"]
глазами : ["которые","которые она"]
глазами которые : ["она"]
гордым : ["лицом","лицом прекрасными"]
гордым лицом : ["прекрасными"]
гордостью : ["называл","называл ее"]
гордостью называл : ["ее"]
город : ["положил","в","положил ей","в суд"]
город положил : ["ей"]
город в : ["суд"]
городском : ["доме","доме еще"]
городском доме : ["еще"]
городе : ["пришлось","пришлось бы"]
городе пришлось : ["бы"]
горничных : ["и","и кухарок"]
горничных и : ["кухарок"]
гораздо : ["чаще","больше","чаще и","больше пределов"]
гораздо чаще : ["и"]
гораздо больше : ["пределов"]
гостей : ["и","и по"]
гостей и : ["по"]
говорили : ["что","что под"]
говорили что : ["под"]
георгины : ["пионы","пионы и"]
георгины пионы : ["и"]
гвоздики : ["а","а также"]
гвоздики а : ["также"]
при : ["какомто","какомто благотворительном"]
при какомто : ["благотворительном"]
приходилось : ["выше","выше средств"]
приходилось выше : ["средств"]
пришлось : ["бы","бы тратиться"]
пришлось бы : ["тратиться"]
пригибаясь : ["и","и выпрямляясь"]
пригибаясь и : ["выпрямляясь"]
пригородного : ["морского","морского курорта"]
пригородного морского : ["курорта"]
приличием : ["и","и модой"]
приличием и : ["модой"]
приличных : ["и","и послушных"]
приличных и : ["послушных"]
принять : ["тайно","тайно католичество"]
принять тайно : ["католичество"]
принимать : ["гостей","гостей и"]
принимать гостей : ["и"]
приехать : ["помочь","помочь сестре"]
приехать помочь : ["сестре"]
приемы : ["благотворить","благотворить хорошо"]
приемы благотворить : ["хорошо"]
привязаны : ["друг","друг к"]
привязаны друг : ["к"]
привлекала : ["внимание","внимание мужчин"]
привлекала внимание : ["мужчин"]
привезти : ["немногих","немногих и"]
привезти немногих : ["и"]
простором : ["пустотой","пустотой и"]
простором пустотой : ["и"]
проста : ["со","со всеми"]
проста со : ["всеми"]
противоречий : []
противно : ["было","было глядеть"]
противно было : ["глядеть"]
прочной : ["верной","верной истинной"]
прочной верной : ["истинной"]
прокурора : ["живший","живший обыкновенно"]
прокурора живший : ["обыкновенно"]
проволоках : ["ласточек","ласточек ста́ившихся"]
проволоках ласточек : ["ста́ившихся"]
предками : ["а","а жить"]
предками а : ["жить"]
пределов : ["дозволяемых","дозволяемых приличием"]
пределов дозволяемых : ["приличием"]
предавалась : ["самому","самому рискованному"]
предавалась самому : ["рискованному"]
предводителя : ["дворянства","дворянства не"]
предводителя дворянства : ["не"]
прекрасными : ["серьгами","хотя","серьгами из","хотя довольно"]
прекрасными серьгами : ["из"]
прекрасными хотя : ["довольно"]
презрительно : ["высмеивала","высмеивала и"]
презрительно высмеивала : ["и"]
прелестью : ["которая","которая заключалась"]
прелестью которая : ["заключалась"]
прелестным : ["дням","дням тишине"]
прелестным дням : ["тишине"]
прежняя : ["страстная","страстная любовь"]
прежняя страстная : ["любовь"]
превращавший : ["глинистые","глинистые дороги"]
превращавший глинистые : ["дороги"]
пустотой : ["и","и оголенностью"]
пустотой и : ["оголенностью"]
пузырьков : []
пышно : ["цвели","цвели своей"]
пышно цвели : ["своей"]
пыль : ["дождик","дождик превращавший"]
пыль дождик : ["превращавший"]
пылко : ["обожала","обожала хорошеньких"]
пылко обожала : ["хорошеньких"]
пикантной : ["задорнококетливой","задорнококетливой мимике"]
пикантной задорнококетливой : ["мимике"]
пионы : ["и","и астры"]
пионы и : ["астры"]
плеч : ["какую","какую можно"]
плеч какую : ["можно"]
плечи : []
плечах : ["живая","живая и"]
плечах живая : ["и"]
пленяло : ["какойто","какойто неуловимой"]
пленяло какойто : ["неуловимой"]
по : ["целым","ним","ночам","спешным","саду","хозяйству","телефону","близорукости","целым суткам","ним в","ночам железные","спешным делам","саду и","телефону приехать","близорукости щурила"]
по спешным : ["делам"]
по саду : ["и"]
по телефону : ["приехать"]
по целым : ["суткам"]
по ним : ["в"]
по ночам : ["железные"]
по близорукости : ["щурила"]
поспешно : ["перебирались","перебирались в"]
поспешно перебирались : ["в"]
послушных : ["с","с бледными"]
послушных с : ["бледными"]
послышались : ["знакомые","знакомые звуки"]
послышались знакомые : ["звуки"]
после : ["своей","своей роскошной"]
после своей : ["роскошной"]
посещала : ["за","за границей"]
посещала за : ["границей"]
потому : ["что","что в"]
потому что : ["в"]
потатарски : ["этого","этого великого"]
потатарски этого : ["великого"]
поцеловались : []
почти : ["совсем","совсем расстроено"]
почти совсем : ["расстроено"]
почемуто : ["они","они у"]
почемуто они : ["у"]
пошла : ["навстречу","в","в мать"]
пошла в : ["мать"]
погоды : ["какие","какие так"]
погоды какие : ["так"]
погода : ["вдруг","вдруг резко"]
погода вдруг : ["резко"]
под : ["низким","низким декольте"]
под низким : ["декольте"]
подъезжала : ["сестра","сестра княгини"]
подъезжала сестра : ["княгини"]
подкованных : ["сапогах","сапогах вздрагивали"]
подкованных сапогах : ["вздрагивали"]
подарок : ["еще","еще больше"]
подарок еще : ["больше"]
покинуть : ["дачи","дачи потому"]
покинуть дачи : ["потому"]
покорно : ["роняли","роняли желтые"]
покорно роняли : ["желтые"]
покончили : ["с","с ремонтом"]
покончили с : ["ремонтом"]
покатостью : ["плеч","плеч какую"]
покатостью плеч : ["какую"]
полях : ["на","на их"]
полях на : ["их"]
полголовы : ["ниже","ниже сестры"]
полголовы ниже : ["сестры"]
положил : ["ей","ей на"]
положил ей : ["на"]
положение : ["в","в обществе"]
положение в : ["обществе"]
полного : ["разорения"]
полной : ["нижней","нижней губе"]
полной нижней : ["губе"]
помочь : ["князю","сестре","князю удержаться","сестре принимать"]
помочь сестре : ["принимать"]
помочь князю : ["удержаться"]
пожалуй : ["даже","даже на"]
пожалуй даже : ["на"]
побережью : ["Черного","Черного моря"]
побережью Черного : ["моря"]
повыбрасывало : ["трупы","трупы рыбаков"]
повыбрасывало трупы : ["рыбаков"]
переставая : ["мелкий","мелкий как"]
переставая мелкий : ["как"]
перешла : ["в","в чувство"]
перешла в : ["чувство"]
перегруженные : ["всяческими","всяческими домашними"]
перегруженные всяческими : ["домашними"]
перед : ["рождением","рождением молодого"]
перед рождением : ["молодого"]
переменилась : []
перебирались : ["в","в город"]
перебирались в : ["город"]
печных : ["трубах"]
печальнее : ["было","было видеть"]
печальнее было : ["видеть"]
парадный : ["обед","обед пожалуй"]
парадный обед : ["пожалуй"]
паутина : []
пахнувших : ["капустой","капустой розовые"]
пахнувших капустой : ["розовые"]
друг : ["к","к другу"]
друг к : ["другу"]
другу : ["теплой","теплой и"]
другу теплой : ["и"]
дружбы : ["всеми","всеми силами"]
дружбы всеми : ["силами"]
дружбой : []
дроги : ["перегруженные","перегруженные всяческими"]
дроги перегруженные : ["всяческими"]
дрогалей : ["закутанных","закутанных от"]
дрогалей закутанных : ["от"]
дрожа : ["коленями","коленями дымясь"]
дрожа коленями : ["дымясь"]
древний : ["род","род которого"]
древний род : ["которого"]
дымясь : ["и","и часто"]
дымясь и : ["часто"]
дико : ["завывало","завывало в"]
дико завывало : ["в"]
диванами : ["сундуками","сундуками стульями"]
диванами сундуками : ["стульями"]
для : ["него","него отказывала"]
для него : ["отказывала"]
до : ["утра","странного","самого","утра шел","странного не","самого Тамерлана"]
до странного : ["не"]
до самого : ["Тамерлана"]
до утра : ["шел"]
дороги : ["и","и тропинки"]
дороги и : ["тропинки"]
дозволяемых : ["приличием","приличием и"]
дозволяемых приличием : ["и"]
доме : ["еще","еще не"]
доме еще : ["не"]
домашними : ["вещами"]
домашнем : ["хозяйстве"]
дождя : ["на","в","на этот","в рогожи"]
дождя на : ["этот"]
дождя в : ["рогожи"]
дождик : ["превращавший","превращавший глинистые"]
дождик превращавший : ["глинистые"]
добротой : ["и","и глубокой"]
добротой и : ["глубокой"]
довольно : ["большими","заметными","большими руками","заметными скулами"]
довольно заметными : ["скулами"]
довольно большими : ["руками"]
дням : ["тишине","тишине уединению"]
дням тишине : ["уединению"]
дни : ["такие","такие ясные"]
дни такие : ["ясные"]
днем : ["и","и ночью"]
днем и : ["ночью"]
деревья : ["бесшумно","бесшумно и"]
деревья бесшумно : ["и"]
деревьев : ["раскачивались","раскачивались пригибаясь"]
деревьев раскачивались : ["пригибаясь"]
держать : ["лошадей","лошадей и"]
держать лошадей : ["и"]
детства : ["она","были","она всегда","были привязаны"]
детства она : ["всегда"]
детства были : ["привязаны"]
детей : ["мальчика","и","младшей","мальчика и","и не","младшей сестры","и даже"]
детей и : ["не","даже"]
детей младшей : ["сестры"]
детей мальчика : ["и"]
дед : ["которого","которого крестился"]
дед которого : ["крестился"]
декольте : ["у","у нее"]
декольте у : ["нее"]
дело : ["останавливались","останавливались дрожа"]
дело останавливались : ["дрожа"]
делать : ["приемы","приемы благотворить"]
делать приемы : ["благотворить"]
делал : ["но","но числился"]
делал но : ["числился"]
делам : ["в","в город"]
делам в : ["город"]
день : ["ее","и","ее именин","и всегда"]
день и : ["всегда"]
день ее : ["именин"]
девочку : []
дач : ["и","и казалось"]
дач и : ["казалось"]
дачи : ["с","потому","с их","потому что"]
дачи с : ["их"]
дачи потому : ["что"]
дачных : ["ворот","ворот круто"]
дачных ворот : ["круто"]
дачным : ["сором","временем","сором из"]
дачным сором : ["из"]
даче : ["можно","можно было"]
даче можно : ["было"]
далее : []
даже : ["в","на","ей","принять","в июле","на бал","ей казалось","принять тайно"]
даже принять : ["тайно"]
даже на : ["бал"]
даже ей : ["казалось"]
даже в : ["июле"]
давно : ["уже","уже перешла"]
давно уже : ["перешла"]
давали : ["в","в третий"]
давали в : ["третий"]
двух : ["детей","детей мальчика"]
двух детей : ["мальчика"]
дворянства : ["не","не могла"]
дворянства не : ["могла"]
дверцу : []
двери : ["и","и дико"]
двери и : ["дико"]
два : ["и","и совсем"]
два и : ["совсем"]
к : ["началу","отлету","мужу","обеденному","другу","тому","началу сентября","отлету и","мужу давно","обеденному столу","другу теплой","тому же"]
к тому : ["же"]
к другу : ["теплой"]
к отлету : ["и"]
к обеденному : ["столу"]
к началу : ["сентября"]
к мужу : ["давно"]
круто : ["остановился","остановился изящный"]
круто остановился : ["изящный"]
кровь : ["отца","отца татарского"]
кровь отца : ["татарского"]
кровли : ["дач","дач и"]
кровли дач : ["и"]
кровопийцу : []
крестился : ["только","только в"]
крестился только : ["в"]
красоты : ["спина","спина грудь"]
красоты спина : ["грудь"]
красотою : ["георгины","георгины пионы"]
красотою георгины : ["пионы"]
красота : ["ее","ее сестры"]
красота ее : ["сестры"]
красавицу : ["англичанку","англичанку своей"]
красавицу англичанку : ["своей"]
ктото : ["бегает","бегает по"]
ктото бегает : ["по"]
курорта : ["большей","большей частью"]
курорта большей : ["частью"]
курортах : ["Европы","Европы но"]
курортах Европы : ["но"]
кусты : ["еще","еще давали"]
кусты еще : ["давали"]
кухарок : ["сидевших","сидевших на"]
кухарок сидевших : ["на"]
кукольными : ["волосами"]
кисею : ["дождя","дождя на"]
кисею дождя : ["на"]
клумбами : ["разбитыми","разбитыми стеклами"]
клумбами разбитыми : ["стеклами"]
корзинками : ["в","в руках"]
корзинками в : ["руках"]
коробочек : ["и","и аптекарских"]
коробочек и : ["аптекарских"]
которые : ["то","она","то и","она к"]
которые то : ["и"]
которые она : ["к"]
который : ["ровно","ровно ничего"]
который ровно : ["ничего"]
которого : ["восходил","крестился","однако","восходил до","крестился только","однако презрительно"]
которого крестился : ["только"]
которого однако : ["презрительно"]
которого восходил : ["до"]
которой : ["увязали","прежняя","увязали надолго","прежняя страстная"]
которой увязали : ["надолго"]
которой прежняя : ["страстная"]
которая : ["заключалась","заставила","заключалась может","заставила ее"]
которая заставила : ["ее"]
которая заключалась : ["может"]
колючей : ["желтой","желтой щетине"]
колючей желтой : ["щетине"]
коленями : ["дымясь","дымясь и"]
коленями дымясь : ["и"]
концы : ["с","с концами"]
концы с : ["концами"]
конца : ["тянулись","тянулись ломовые"]
конца тянулись : ["ломовые"]
концами : []
княгини : ["Веры","Веры Анна"]
княгини Веры : ["Анна"]
князю : ["удержаться","удержаться от"]
князю удержаться : ["от"]
князя : ["дед","дед которого"]
князя дед : ["которого"]
касается : ["Веры","Веры та"]
касается Веры : ["та"]
католичество : []
кафе : ["но","но в"]
кафе но : ["в"]
капустой : ["розовые","розовые кусты"]
капустой розовые : ["кусты"]
как : ["водяная","все","с","водяная пыль","все южане","с гордостью"]
как с : ["гордостью"]
как все : ["южане"]
как водяная : ["пыль"]
какую : ["можно","можно видеть"]
какую можно : ["видеть"]
каких : ["не","не было"]
каких не : ["было"]
какимито : ["утюгами","утюгами жестянками"]
какимито утюгами : ["жестянками"]
какие : ["так","так свойственны"]
какие так : ["свойственны"]
какомто : ["благотворительном","благотворительном учреждении"]
какомто благотворительном : ["учреждении"]
какойто : ["неуловимой","неуловимой и"]
какойто неуловимой : ["и"]
казалось : ["будто","чем","будто ктото","чем больше"]
казалось чем : ["больше"]
казалось будто : ["ктото"]
казавшийся : ["таким","таким изношенным"]
казавшийся таким : ["изношенным"]
камерюнкера : []
и : ["ночью","тогда","морем","экипажи","тропинки","дико","казалось","выпрямляясь","совсем","мнительные","евреи","нищенским","противно","грустно","часто","дело","корзинками","кухарок","аптекарских","всяческим","оголенностью","теплые","покорно","ласковому","всегда","этот","только","благодаря","так","насколько","осторожно","имели","розы","астры","чрезмерного","по","шофер","заботливой","той","гордым","древний","легкомысленная","непонятной","сильнее","привлекала","имел","очень","девочку","не","с","послушных","пылко","она","даже","милых","за","в","на","глубокой","плечи","модой","царственно","немного","ночью точно","тогда огромная","морем густой","тропинки в","дико завывало","казалось будто","выпрямляясь точно","совсем не","мнительные как","евреи жизнелюбивые","противно было","грустно и","часто нося","дело останавливались","корзинками в","кухарок сидевших","аптекарских пузырьков","всяческим дачным","оголенностью с","совсем нежданно","теплые каких","покорно роняли","ласковому соленому","всегда ожидала","этот подарок","только самых","благодаря ему","так далее","насколько возможно","осторожно срезала","имели беспорядочный","розы но","астры распространяя","чрезмерного обильного","по хозяйству","шофер ловко","заботливой дружбой","той очаровательной","гордым лицом","древний род","легкомысленная насмешница","непонятной прелестью","сильнее чем","привлекала внимание","имел звание","очень глупым","не имела","с завитыми","послушных с","пылко обожала","она болезненно","даже ей","милых иногда","за глаза","в глаза","на всех","глубокой искренней","модой но","царственно спокойна","немного свысока"]
и розы : ["но"]
и с : ["завитыми"]
и сильнее : ["чем"]
и совсем : ["не","нежданно"]
и тропинки : ["в"]
и тогда : ["огромная"]
и только : ["самых"]
и той : ["очаровательной"]
и теплые : ["каких"]
и так : ["далее"]
и царственно : ["спокойна"]
и чрезмерного : ["обильного"]
и часто : ["нося"]
и шофер : ["ловко"]
и этот : ["подарок"]
и грустно : ["и"]
и глубокой : ["искренней"]
и гордым : ["лицом"]
и привлекала : ["внимание"]
и противно : ["было"]
и пылко : ["обожала"]
и по : ["хозяйству"]
и послушных : ["с"]
и покорно : ["роняли"]
и древний : ["род"]
и дико : ["завывало"]
и дело : ["останавливались"]
и даже : ["ей"]
и кухарок : ["сидевших"]
и корзинками : ["в"]
и казалось : ["будто"]
и имел : ["звание"]
и имели : ["беспорядочный"]
и за : ["глаза"]
и заботливой : ["дружбой"]
и легкомысленная : ["насмешница"]
и ласковому : ["соленому"]
и осторожно : ["срезала"]
и очень : ["глупым"]
и оголенностью : ["с"]
и она : ["болезненно"]
и ночью : ["точно"]
и не : ["имела"]
и непонятной : ["прелестью"]
и немного : ["свысока"]
и на : ["всех"]
и насколько : ["возможно"]
и милых : ["иногда"]
и морем : ["густой"]
и модой : ["но"]
и мнительные : ["как"]
и евреи : ["жизнелюбивые"]
и астры : ["распространяя"]
и аптекарских : ["пузырьков"]
и благодаря : ["ему"]
и в : ["глаза"]
и всяческим : ["дачным"]
и всегда : ["ожидала"]
и выпрямляясь : ["точно"]
истинной : ["дружбы","дружбы всеми"]
истинной дружбы : ["всеми"]
искренней : ["набожностью","набожностью которая"]
искренней набожностью : ["которая"]
их : ["внезапным","колючей","городском","внезапным простором","колючей желтой","городском доме"]
их городском : ["доме"]
их колючей : ["желтой"]
их внезапным : ["простором"]
июле : []
игры : ["танцы","танцы сильные"]
игры танцы : ["сильные"]
из : ["окурков","грушевидных","веселой","окурков бумажек","грушевидных жемчужин","веселой безалаберности"]
из грушевидных : ["жемчужин"]
из окурков : ["бумажек"]
из веселой : ["безалаберности"]
изуродованными : ["клумбами","клумбами разбитыми"]
изуродованными клумбами : ["разбитыми"]
изящный : ["автомобилькарета","автомобилькарета и"]
изящный автомобилькарета : ["и"]
изношенным : ["грязным","грязным и"]
изношенным грязным : ["и"]
измельчавшие : ["редкие","редкие точно"]
измельчавшие редкие : ["точно"]
изменяла : ["мужу","мужу которого"]
изменяла мужу : ["которого"]
или : ["ЛангТемира","ЛангТемира как"]
или ЛангТемира : ["как"]
иногда : ["странных","странных противоречий"]
иногда странных : ["противоречий"]
иметь : ["детей","детей и"]
иметь детей : ["и"]
имел : ["звание","звание камерюнкера"]
имел звание : ["камерюнкера"]
имели : ["беспорядочный","беспорядочный вид"]
имели беспорядочный : ["вид"]
имела : []
именин : ["сентября"]
именины : ["совпали","совпали с"]
именины совпали : ["с"]
имение : ["было","было почти"]
имение было : ["почти"]
зрелища : ["посещала","посещала за"]
зрелища посещала : ["за"]
здесь : ["на","на даче"]
здесь на : ["даче"]
знакомых : []
знакомые : ["звуки","звуки автомобильного"]
знакомые звуки : ["автомобильного"]
зеленых : ["стручьях","стручьях пахнувших"]
зеленых стручьях : ["пахнувших"]
землю : ["бесчисленные","бесчисленные семена"]
землю бесчисленные : ["семена"]
землею : ["и","и морем"]
землею и : ["морем"]
за : ["это","очень","глаза","границей","это лето","очень богатым","границей сомнительные"]
за это : ["лето"]
за границей : ["сомнительные"]
за очень : ["богатым"]
заставила : ["ее","ее даже"]
заставила ее : ["даже"]
запотевших : ["обессилевших","обессилевших лошадей"]
запотевших обессилевших : ["лошадей"]
запах : []
задувал : ["с","с северозапада"]
задувал с : ["северозапада"]
задорнококетливой : ["мимике"]
закутанных : ["от","от дождя"]
закутанных от : ["дождя"]
заключалась : ["может","может быть"]
заключалась может : ["быть"]
замужем : ["за","за очень"]
замужем за : ["очень"]
заметными : ["скулами","скулами с"]
заметными скулами : ["с"]
заблудилось : ["в","в море"]
заблудилось в : ["море"]
заблестела : ["слюдяным","слюдяным блеском"]
заблестела слюдяным : ["блеском"]
заботливой : ["дружбой"]
завывало : ["в","в печных"]
завывало в : ["печных"]
завитыми : ["льняными","льняными кукольными"]
завитыми льняными : ["кукольными"]
звуки : ["автомобильного","автомобильного трехтонного"]
звуки автомобильного : ["трехтонного"]
звание : ["камерюнкера"]
лучше : ["но","но почемуто"]
лучше но : ["почемуто"]
льняными : ["кукольными","кукольными волосами"]
льняными кукольными : ["волосами"]
любила : ["этот","азартные","этот день","азартные игры"]
любила этот : ["день"]
любила азартные : ["игры"]
любовь : ["к","к мужу"]
любовь к : ["мужу"]
любезна : ["независима","независима и"]
любезна независима : ["и"]
любви : ["и","и чрезмерного"]
любви и : ["чрезмерного"]
листья : []
лицо : ["это","это однако"]
лицо это : ["однако"]
лицом : ["прекрасными","прекрасными хотя"]
лицом прекрасными : ["хотя"]
лицами : ["и","и с"]
лицами и : ["с"]
лошадей : ["которые","и","которые то","и так"]
лошадей которые : ["то"]
лошадей и : ["так"]
ломовые : ["дроги","дроги перегруженные"]
ломовые дроги : ["перегруженные"]
ловко : ["спрыгнув","спрыгнув с"]
ловко спрыгнув : ["с"]
лето : ["бутоны","бутоны и"]
лето бутоны : ["и"]
летнего : ["материнства","материнства тихо"]
летнего материнства : ["тихо"]
легкомысленная : ["насмешница"]
лежал : ["над","над землею"]
лежал над : ["землею"]
левкой : ["наполовину","наполовину в"]
левкой наполовину : ["в"]
ласточек : ["ста́ившихся","ста́ившихся к"]
ласточек ста́ившихся : ["к"]
ласковому : ["соленому","соленому ветерку"]
ласковому соленому : ["ветерку"]
острые : ["зрелища","зрелища посещала"]
острые зрелища : ["посещала"]
осторожно : ["срезала","срезала ножницами"]
осторожно срезала : ["ножницами"]
остановился : ["изящный","изящный автомобилькарета"]
остановился изящный : ["автомобилькарета"]
останавливались : ["дрожа","дрожа коленями"]
останавливались дрожа : ["коленями"]
оставленные : ["дачи","дачи с"]
оставленные дачи : ["с"]
осыпали : ["на","на землю"]
осыпали на : ["землю"]
особенно : ["в","в слегка"]
особенно в : ["слегка"]
осенняя : ["паутина"]
осенний : ["травянистый","травянистый грустный"]
осенний травянистый : ["грустный"]
от : ["него","дождя","полного","него верхушки","дождя в","него чегото","полного разорения","него двух"]
от полного : ["разорения"]
от дождя : ["в"]
от него : ["верхушки","чегото","двух"]
отца : ["татарского","татарского князя"]
отца татарского : ["князя"]
отдаленным : ["воспоминаниям","воспоминаниям детства"]
отдаленным воспоминаниям : ["детства"]
отказывала : ["себе","себе и"]
отказывала себе : ["и"]
отличалась : ["щедрой","щедрой добротой"]
отличалась щедрой : ["добротой"]
отлету : ["и","и ласковому"]
отлету и : ["ласковому"]
отец : ["потатарски","потатарски этого"]
отец потатарски : ["этого"]
отвратительные : ["погоды","погоды какие"]
отвратительные погоды : ["какие"]
охотно : ["предавалась","предавалась самому"]
охотно предавалась : ["самому"]
очень : ["радовалась","глупым","богатым","радовалась наступившим","глупым человеком","богатым и"]
очень радовалась : ["наступившим"]
очень глупым : ["человеком"]
очень богатым : ["и"]
очаровательной : ["покатостью","покатостью плеч"]
очаровательной покатостью : ["плеч"]
огромная : ["сирена","сирена на"]
огромная сирена : ["на"]
оголенностью : ["с","с изуродованными"]
оголенностью с : ["изуродованными"]
опустели : ["и","и имели"]
опустели и : ["имели"]
одна : ["во","во всем"]
одна во : ["всем"]
однако : ["пленяло","презрительно","пленяло какойто","презрительно высмеивала"]
однако презрительно : ["высмеивала"]
однако пленяло : ["какойто"]
одеваться : ["держать","держать лошадей"]
одеваться держать : ["лошадей"]
окурков : ["бумажек","бумажек черепков"]
окурков бумажек : ["черепков"]
оконные : ["рамы","рамы хлопали"]
оконные рамы : ["хлопали"]
они : ["до","у","до странного","у нее"]
они у : ["нее"]
они до : ["странного"]
она : ["очень","всегда","ходила","к","терпеть","решила","болезненно","обнажалась","очень радовалась","всегда любила","ходила по","к тому","терпеть не","решила не","болезненно и","обнажалась гораздо"]
она решила : ["не"]
она терпеть : ["не"]
она ходила : ["по"]
она к : ["тому"]
она очень : ["радовалась"]
она обнажалась : ["гораздо"]
она болезненно : ["и"]
она всегда : ["любила"]
ожидала : ["от","от него"]
ожидала от : ["него"]
обсохших : ["сжатых","сжатых полях"]
обсохших сжатых : ["полях"]
обществе : ["а","а может"]
обществе а : ["может"]
обыкновенно : ["вместе","вместе с"]
обыкновенно вместе : ["с"]
обильного : ["летнего","летнего материнства"]
обильного летнего : ["материнства"]
обожала : ["хорошеньких","хорошеньких малокровных"]
обожала хорошеньких : ["малокровных"]
обойтись : ["самыми","самыми небольшими"]
обойтись самыми : ["небольшими"]
обнажалась : ["гораздо","гораздо больше"]
обнажалась гораздо : ["больше"]
обманул : ["Веру"]
обессилевших : ["лошадей","лошадей которые"]
обессилевших лошадей : ["которые"]
обещал : ["привезти","привезти немногих"]
обещал привезти : ["немногих"]
обещавшая : ["по","по телефону"]
обещавшая по : ["телефону"]
обед : ["пожалуй","пожалуй даже"]
обед пожалуй : ["даже"]
обеду : ["муж","муж обещал"]
обеду муж : ["обещал"]
обеденному : ["столу"]
ничего : ["не","не делал"]
ничего не : ["делал"]
нищенским : []
никогда : ["не","не изменяла"]
никогда не : ["изменяла"]
низким : ["декольте","декольте у"]
низким декольте : ["у"]
ним : ["в","в подкованных"]
ним в : ["подкованных"]
ними : ["также","также уехал"]
ними также : ["уехал"]
нижней : ["губе","губе лицо"]
нижней губе : ["лицо"]
ниже : ["сестры","сестры несколько"]
ниже сестры : ["несколько"]
но : ["уже","холодным","числился","родила","почемуто","никогда","в","говорили","уже измельчавшие","холодным и","числился при","родила от","почемуто они","никогда не","в то","говорили что"]
но родила : ["от"]
но уже : ["измельчавшие"]
но холодным : ["и"]
но числился : ["при"]
но говорили : ["что"]
но почемуто : ["они"]
но никогда : ["не"]
но в : ["то"]
нося : ["боками","боками на"]
нося боками : ["на"]
ночью : ["точно","точно бешеный"]
ночью точно : ["бешеный"]
ночной : ["столик","столик футляр"]
ночной столик : ["футляр"]
ночам : ["железные","железные кровли"]
ночам железные : ["кровли"]
ножницами : ["цветы","цветы к"]
ножницами цветы : ["к"]
не : ["переставая","вернулись","было","покончили","могла","обманул","были","делал","имела","иметь","рождались","изменяла","переставая мелкий","было даже","покончили с","могла покинуть","обманул Веру","были схожи","делал но","могла но","иметь детей","рождались и","изменяла мужу"]
не рождались : ["и"]
не покончили : ["с"]
не переставая : ["мелкий"]
не делал : ["но"]
не изменяла : ["мужу"]
не иметь : ["детей"]
не обманул : ["Веру"]
не могла : ["покинуть","но"]
не были : ["схожи"]
не было : ["даже"]
несколько : ["минут","широкая","минут у","широкая в"]
несколько широкая : ["в"]
несколько минут : ["у"]
несмотря : ["на","на свое"]
несмотря на : ["свое"]
неуловимой : ["и","и непонятной"]
неуловимой и : ["непонятной"]
него : ["верхушки","чегото","отказывала","двух","верхушки деревьев","чегото счастливочудесного","отказывала себе","двух детей"]
него чегото : ["счастливочудесного"]
него двух : ["детей"]
него отказывала : ["себе"]
него верхушки : ["деревьев"]
непонятной : ["прелестью","прелестью которая"]
непонятной прелестью : ["которая"]
неделю : ["повыбрасывало","повыбрасывало трупы"]
неделю повыбрасывало : ["трупы"]
некрасивость : ["возбуждала","возбуждала и"]
некрасивость возбуждала : ["и"]
незаметно : ["для","для него"]
незаметно для : ["него"]
независима : ["и","и царственно"]
независима и : ["царственно"]
немногих : ["и","и только"]
немногих и : ["только"]
немного : ["свысока","свысока любезна"]
немного свысока : ["любезна"]
нее : ["не","были","всегда","не рождались","были редкой","всегда была"]
нее не : ["рождались"]
нее были : ["редкой"]
нее всегда : ["была"]
нежданно : ["переменилась"]
нежным : ["но","но холодным"]
нежным но : ["холодным"]
небольшими : ["расходами"]
на : ["маяке","этот","сипло","запотевших","мокром","верху","горничных","их","телеграфных","ночной","даче","бал","большой","свое","землю","шоссе","старинных","полголовы","всех","большие","маяке ревела","этот жалкий","сипло ругавшихся","запотевших обессилевших","мокром брезенте","верху воза","горничных и","их колючей","телеграфных проволоках","ночной столик","даче можно","бал а","большой парадный","свое видное","землю бесчисленные","шоссе послышались","старинных миниатюрах","полголовы ниже","всех курортах","большие балы"]
на старинных : ["миниатюрах"]
на сипло : ["ругавшихся"]
на свое : ["видное"]
на телеграфных : ["проволоках"]
на шоссе : ["послышались"]
на этот : ["жалкий"]
на горничных : ["и"]
на полголовы : ["ниже"]
на даче : ["можно"]
на их : ["колючей"]
на землю : ["бесчисленные"]
на запотевших : ["обессилевших"]
на ночной : ["столик"]
на мокром : ["брезенте"]
на маяке : ["ревела"]
на большие : ["балы"]
на большой : ["парадный"]
на бал : ["а"]
на всех : ["курортах"]
на верху : ["воза"]
наступили : ["отвратительные","тихие","отвратительные погоды","тихие безоблачные"]
наступили тихие : ["безоблачные"]
наступили отвратительные : ["погоды"]
наступившим : ["прелестным","прелестным дням"]
наступившим прелестным : ["дням"]
насколько : ["возможно","возможно экономила"]
насколько возможно : ["экономила"]
насмешница : []
началу : ["сентября","сентября погода"]
началу сентября : ["погода"]
начале : ["столетия","столетия и"]
начале столетия : ["и"]
наполовину : ["в","в тонких","в цветах"]
наполовину в : ["тонких","цветах"]
над : ["землею","землею и"]
над землею : ["и"]
надолго : ["возы","возы и"]
надолго возы : ["и"]
надменным : ["выражением","выражением в"]
надменным выражением : ["в"]
надета : ["власяница"]
называл : ["ее","ее отец"]
называл ее : ["отец"]
наоборот : ["унаследовала","унаследовала монгольскую"]
наоборот унаследовала : ["монгольскую"]
набожностью : ["которая","которая заставила"]
набожностью которая : ["заставила"]
навстречу : []
мутную : ["кисею","кисею дождя"]
мутную кисею : ["дождя"]
мучнистыми : ["лицами","лицами и"]
мучнистыми лицами : ["и"]
муж : ["обещал","обещал привезти"]
муж обещал : ["привезти"]
мужу : ["давно","которого","давно уже","которого однако"]
мужу давно : ["уже"]
мужу которого : ["однако"]
мужчин : ["гораздо","гораздо чаще"]
мужчин гораздо : ["чаще"]
милых : ["иногда","иногда странных"]
милых иногда : ["странных"]
милым : ["отдаленным","отдаленным воспоминаниям"]
милым отдаленным : ["воспоминаниям"]
минут : ["у","у дачных"]
минут у : ["дачных"]
миниатюрах : []
мимике : []
младшей : ["сестры","сестры всегда"]
младшей сестры : ["всегда"]
морского : ["курорта","курорта большей"]
морского курорта : ["большей"]
моря : []
море : ["а","а два"]
море а : ["два"]
морем : ["густой","густой туман"]
морем густой : ["туман"]
могла : ["покинуть","но","покинуть дачи","но родила"]
могла покинуть : ["дачи"]
могла но : ["родила"]
модой : ["но","но говорили"]
модой но : ["говорили"]
мокром : ["брезенте","брезенте с"]
мокром брезенте : ["с"]
молодого : ["месяца","месяца вдруг"]
молодого месяца : ["вдруг"]
монгольскую : ["кровь","кровь отца"]
монгольскую кровь : ["отца"]
монгольского : ["типа","типа с"]
монгольского типа : ["с"]
можно : ["было","видеть","было обойтись","видеть на"]
можно было : ["обойтись"]
можно видеть : ["на"]
может : ["быть","быть и","быть в"]
может быть : ["и","в"]
мнительные : ["как","как все"]
мнительные как : ["все"]
многом : ["незаметно","незаметно для"]
многом незаметно : ["для"]
местах : ["берега"]
месяца : ["вдруг","вдруг наступили"]
месяца вдруг : ["наступили"]
мелкий : ["как","как водяная"]
мелкий как : ["водяная"]
между : ["собою"]
мать : ["красавицу","красавицу англичанку"]
мать красавицу : ["англичанку"]
материнства : ["тихо","тихо осыпали"]
материнства тихо : ["осыпали"]
махровые : ["гвоздики","гвоздики а"]
махровые гвоздики : ["а"]
маяке : ["ревела","ревела днем"]
маяке ревела : ["днем"]
мальчика : ["и","и девочку"]
мальчика и : ["девочку"]
малокровных : ["детей","детей младшей"]
малокровных детей : ["младшей"]
маленьком : ["чувственном","чувственном рте"]
маленьком чувственном : ["рте"]
еще : ["не","больше","давали","не покончили","больше веселил","давали в"]
еще давали : ["в"]
еще не : ["покончили"]
еще больше : ["веселил"]
его : ["предками","предками а"]
его предками : ["а"]
едва : ["сводил","сводил концы"]
едва сводил : ["концы"]
ему : ["едва","едва сводил"]
ему едва : ["сводил"]
ее : ["именин","отец","сильно","сестры","даже","именин сентября","отец потатарски","сильно монгольского","даже принять"]
ее сильно : ["монгольского"]
ее даже : ["принять"]
ее именин : ["сентября"]
ее отец : ["потатарски"]
ей : ["на","казалось","на ночной","казалось чем"]
ей казалось : ["чем"]
ей на : ["ночной"]
евреи : ["жизнелюбивые","жизнелюбивые и"]
евреи жизнелюбивые : ["и"]
жить : ["приходилось","приходилось выше"]
жить приходилось : ["выше"]
жизни : []
жизнелюбивые : ["и","и мнительные"]
жизнелюбивые и : ["мнительные"]
живший : ["обыкновенно","обыкновенно вместе"]
живший обыкновенно : ["вместе"]
живая : ["и","и легкомысленная"]
живая и : ["легкомысленная"]
же : ["по","время","была","по близорукости","время отличалась","была строго"]
же по : ["близорукости"]
же была : ["строго"]
же время : ["отличалась"]
жестянками : ["и","и корзинками"]
жестянками и : ["корзинками"]
желтые : ["листья"]
желтой : ["щетине","щетине заблестела"]
желтой щетине : ["заблестела"]
железные : ["кровли","кровли дач"]
железные кровли : ["дач"]
женственности : ["всех","всех черт"]
женственности всех : ["черт"]
жена : ["предводителя","предводителя дворянства"]
жена предводителя : ["дворянства"]
жемчужин : ["и","и этот"]
жемчужин и : ["этот"]
жадно : ["хотела","хотела детей"]
жадно хотела : ["детей"]
жалкий : ["скарб","скарб казавшийся"]
жалкий скарб : ["казавшийся"]
а : ["два","здесь","может","жить","наполовину","также","два и","здесь на","может быть","жить приходилось","наполовину в","также левкой"]
а также : ["левкой"]
а два : ["и"]
а здесь : ["на"]
а наполовину : ["в"]
а может : ["быть"]
а жить : ["приходилось"]
аристократическая : ["красота","красота ее"]
аристократическая красота : ["ее"]
астры : ["распространяя","распространяя в"]
астры распространяя : ["в"]
аптекарских : ["пузырьков"]
азартные : ["игры","игры танцы"]
азартные игры : ["танцы"]
англичанку : ["своей","своей высокой"]
англичанку своей : ["высокой"]
автомобилькарета : ["и","и шофер"]
автомобилькарета и : ["шофер"]
автомобильного : ["трехтонного","трехтонного рожка"]
автомобильного трехтонного : ["рожка"]
августа : ["перед","перед рождением"]
августа перед : ["рождением"]
брошенными : ["собаками","собаками и"]
брошенными собаками : ["и"]
брезенте : ["с","с какимито"]
брезенте с : ["какимито"]
брат : ["Николай","Николай товарищ"]
брат Николай : ["товарищ"]
бурю : ["гремели","гремели по"]
бурю гремели : ["по"]
бутоны : ["и","и розы"]
бутоны и : ["розы"]
будто : ["ктото","ктото бегает"]
будто ктото : ["бегает"]
будущей : ["жизни"]
бумажек : ["черепков","черепков коробочек"]
бумажек черепков : ["коробочек"]
бы : ["тратиться","тратиться на"]
бы тратиться : ["на"]
быть : ["и","в","и благодаря","в пикантной","в глубокой","в улыбке"]
быть и : ["благодаря"]
быть в : ["пикантной","глубокой","улыбке"]
бык : []
был : ["день","день ее"]
был день : ["ее"]
были : ["привязаны","схожи","редкой","привязаны друг","схожи между","редкой красоты"]
были редкой : ["красоты"]
были схожи : ["между"]
были привязаны : ["друг"]
было : ["глядеть","видеть","даже","обойтись","почти","глядеть сквозь","видеть оставленные","даже в","обойтись самыми","почти совсем"]
было глядеть : ["сквозь"]
было почти : ["совсем"]
было даже : ["в"]
было обойтись : ["самыми"]
было видеть : ["оставленные"]
была : ["одна","на","замужем","расточительна","надета","строго","одна во","на полголовы","замужем за","расточительна страшно","надета власяница","строго проста"]
была расточительна : ["страшно"]
была строго : ["проста"]
была замужем : ["за"]
была одна : ["во"]
была на : ["полголовы"]
была надета : ["власяница"]
близких : ["знакомых"]
близорукости : ["щурила","щурила с"]
близорукости щурила : ["с"]
блеском : ["осенняя","осенняя паутина"]
блеском осенняя : ["паутина"]
бледными : ["мучнистыми","мучнистыми лицами"]
бледными мучнистыми : ["лицами"]
благотворить : ["хорошо","хорошо одеваться"]
благотворить хорошо : ["одеваться"]
благотворительном : ["учреждении","учреждении и"]
благотворительном учреждении : ["и"]
благодаря : ["ему","ему едва"]
благодаря ему : ["едва"]
богатым : ["и","и очень"]
богатым и : ["очень"]
боками : ["на","на сипло"]
боками на : ["сипло"]
большими : ["руками","руками и"]
большими руками : ["и"]
большие : ["балы","балы она"]
большие балы : ["она"]
большой : ["парадный","парадный обед"]
большой парадный : ["обед"]
больше : ["веселил","она","тем","пределов","веселил ее","она решила","тем лучше","пределов дозволяемых"]
больше тем : ["лучше"]
больше пределов : ["дозволяемых"]
больше она : ["решила"]
больше веселил : ["ее"]
большей : ["частью","частью греки"]
большей частью : ["греки"]
болезненно : ["и","и пылко"]
болезненно и : ["пылко"]
берега : []
бесчисленные : ["семена","семена будущей"]
бесчисленные семена : ["будущей"]
бесшумно : ["и","и покорно"]
бесшумно и : ["покорно"]
беспорядочный : ["вид"]
бешеный : ["бык"]
бегает : ["по","по ним"]
бегает по : ["ним"]
без : ["конца","конца тянулись"]
без конца : ["тянулись"]
безоблачные : ["дни","дни такие"]
безоблачные дни : ["такие"]
безалаберности : ["и","и милых"]
безалаберности и : ["милых"]
баркасов : ["заблудилось","заблудилось в"]
баркасов заблудилось : ["в"]
бал : ["а","а здесь"]
бал а : ["здесь"]
балы : ["она","она обнажалась"]
балы она : ["обнажалась"]
в : ["которой","сплошную","печных","подкованных","бурю","море","разных","город","рогожи","руках","июле","их","суд","обществе","чувство","домашнем","третий","тонких","цветах","чутком","мать","начале","плечах","пикантной","глубокой","улыбке","слегка","маленьком","глаза","то","которой увязали","сплошную густую","печных трубах","подкованных сапогах","бурю гремели","море а","разных местах","руках на","их городском","город положил","город в","обществе а","чувство прочной","домашнем хозяйстве","третий раз","тонких зеленых","цветах а","чутком воздухе","мать красавицу","начале столетия","плечах живая","пикантной задорнококетливой","глубокой женственности","улыбке может","слегка выдвинутой","маленьком чувственном","глаза и","то же"]
в руках : ["на"]
в разных : ["местах"]
в сплошную : ["густую"]
в слегка : ["выдвинутой"]
в третий : ["раз"]
в то : ["же"]
в тонких : ["зеленых"]
в улыбке : ["может"]
в цветах : ["а"]
в чутком : ["воздухе"]
в чувство : ["прочной"]
в глубокой : ["женственности"]
в глаза : ["и"]
в город : ["положил","в"]
в пикантной : ["задорнококетливой"]
в плечах : ["живая"]
в подкованных : ["сапогах"]
в печных : ["трубах"]
в домашнем : ["хозяйстве"]
в которой : ["увязали"]
в их : ["городском"]
в обществе : ["а"]
в начале : ["столетия"]
в море : ["а"]
в мать : ["красавицу"]
в маленьком : ["чувственном"]
в бурю : ["гремели"]
время : ["отличалась","отличалась щедрой"]
время отличалась : ["щедрой"]
временем : []
вся : ["состояла","состояла из"]
вся состояла : ["из"]
всяческим : ["дачным","дачным сором"]
всяческим дачным : ["сором"]
всяческими : ["домашними","домашними вещами"]
всяческими домашними : ["вещами"]
все : ["южане","южане поспешно"]
все южане : ["поспешно"]
всех : ["черт","курортах","столицах","черт может","курортах Европы","столицах и"]
всех столицах : ["и"]
всех черт : ["может"]
всех курортах : ["Европы"]
всегда : ["ожидала","любила","приличных","была","ожидала от","любила этот","приличных и","была надета"]
всегда приличных : ["и"]
всегда любила : ["этот"]
всегда ожидала : ["от"]
всегда была : ["надета"]
всем : ["доме"]
всеми : ["силами","холодно","силами старалась","холодно и"]
всеми силами : ["старалась"]
всеми холодно : ["и"]
выродившиеся : []
выражением : ["в","в маленьком"]
выражением в : ["маленьком"]
высокомерной : ["красотою","красотою георгины"]
высокомерной красотою : ["георгины"]
высокой : ["гибкой","гибкой фигурой"]
высокой гибкой : ["фигурой"]
высмеивала : ["и","и в"]
высмеивала и : ["в"]
выходило : ["что","что именины"]
выходило что : ["именины"]
выше : ["средств"]
выпрямляясь : ["точно","точно волны"]
выпрямляясь точно : ["волны"]
выдвинутой : ["вперед","вперед полной"]
выдвинутой вперед : ["полной"]
вперед : ["полной","полной нижней"]
вперед полной : ["нижней"]
впечатления : ["острые","острые зрелища"]
впечатления острые : ["зрелища"]
вдруг : ["наступили","резко","наступили отвратительные","резко и"]
вдруг резко : ["и"]
вдруг наступили : ["отвратительные"]
вид : []
видное : ["положение","положение в"]
видное положение : ["в"]
видеть : ["оставленные","на","оставленные дачи","на старинных"]
видеть оставленные : ["дачи"]
видеть на : ["старинных"]
вздрагивали : ["оконные","оконные рамы"]
вздрагивали оконные : ["рамы"]
власяница : []
во : ["всем","многом","всех","всем доме","многом незаметно","всех столицах"]
во многом : ["незаметно"]
во всех : ["столицах"]
во всем : ["доме"]
ворот : ["круто","круто остановился"]
ворот круто : ["остановился"]
восходил : ["до","до самого"]
восходил до : ["самого"]
воспоминаниям : ["детства","детства она"]
воспоминаниям детства : ["она"]
водяная : ["пыль","пыль дождик"]
водяная пыль : ["дождик"]
возы : ["и","и экипажи"]
возы и : ["экипажи"]
воздуху : ["щебетанью","щебетанью на"]
воздуху щебетанью : ["на"]
воздухе : ["осенний","осенний травянистый"]
воздухе осенний : ["травянистый"]
возможно : ["экономила","экономила в"]
возможно экономила : ["в"]
воза : ["на","на мокром"]
воза на : ["мокром"]
возбуждала : ["и","и привлекала"]
возбуждала и : ["привлекала"]
волосами : []
волны : ["в","в бурю"]
волны в : ["бурю"]
внимание : ["мужчин","мужчин гораздо"]
внимание мужчин : ["гораздо"]
внешности : ["они","они до"]
внешности они : ["до"]
внезапным : ["простором","простором пустотой"]
внезапным простором : ["пустотой"]
вместе : ["с","с ними"]
вместе с : ["ними"]
верху : ["воза","воза на"]
верху воза : ["на"]
верхушки : ["деревьев","деревьев раскачивались"]
верхушки деревьев : ["раскачивались"]
вернулись : []
верной : ["истинной","истинной дружбы"]
верной истинной : ["дружбы"]
веселил : ["ее"]
веселой : ["безалаберности","безалаберности и"]
веселой безалаберности : ["и"]
ветерку : ["слабо","слабо тянувшему"]
ветерку слабо : ["тянувшему"]
вещами : []
великого : ["кровопийцу"]
