XIX : ["столетия","столетия обе"]
XIX столетия : ["обе"]
«Боярский : ["пир»","пир» и"]
«Боярский пир» : ["и"]
«Иди : ["негодяй","негодяй и"]
«Иди негодяй : ["и"]
«Купанье» : ["с","с хрустальной"]
«Купанье» с : ["хрустальной"]
«Папа : ["меня","меня ученики"]
«Папа меня : ["ученики"]
«СтароКиевский» : ["и","и Анны"]
«СтароКиевский» и : ["Анны"]
«Я : ["тебе","тебе больше"]
«Я тебе : ["больше"]
«экономочкой» : []
А : ["на","перед","дворник","она","вот","девицы","о","всетаки","на Малой","перед вечером","дворник украсил","она дразня","вот у","девицы только","о своих","всетаки мой"]
А вот : ["у"]
А всетаки : ["мой"]
А дворник : ["украсил"]
А девицы : ["только"]
А на : ["Малой"]
А о : ["своих"]
А она : ["дразня"]
А перед : ["вечером"]
Аа : []
Айайай : []
Амура : ["и","и своей"]
Амура и : ["своей"]
Анна : ["Марковна","Марковна служила","Марковна удалясь","Марковна отвесив"]
Анна Марковна : ["служила","удалясь","отвесив"]
Анночка : ["вся","вся покраснела"]
Анночка вся : ["покраснела"]
Анны : ["Марковны","Марковны несколько","Марковны все"]
Анны Марковны : ["несколько","все"]
Аргумент : []
Ах : ["и","и не"]
Ах и : ["не"]
Берточку : ["она","она в"]
Берточку она : ["в"]
Благодарюс : []
Большая : ["Ямская","квадратная","Ямская и","квадратная зала"]
Большая Ямская : ["и"]
Большая квадратная : ["зала"]
Большой : ["Ямской","рыжий","Ямской рублевые","рыжий пес"]
Большой Ямской : ["рублевые"]
Большой рыжий : ["пес"]
Большую : ["Ямскую","Ямскую первый"]
Большую Ямскую : ["первый"]
В : ["комнате","дверь","доме","комнате хозяйки","дверь стучат","доме темно"]
В дверь : ["стучат"]
В доме : ["темно"]
В комнате : ["хозяйки"]
Васильевны : ["«СтароКиевский»","«СтароКиевский» и"]
Васильевны «СтароКиевский» : ["и"]
Ваши : ["гостис"]
Ведь : ["вам","это","вам только","это служба"]
Ведь вам : ["только"]
Ведь это : ["служба"]
Весь : ["город","город знает"]
Весь город : ["знает"]
Во : ["всех","второстепенном","всех домах","второстепенном двухрублевом"]
Во всех : ["домах"]
Во второстепенном : ["двухрублевом"]
Вот : ["у","и","у меня","и у"]
Вот и : ["у"]
Вот у : ["меня"]
Впоследствии : ["когда","когда паровая"]
Впоследствии когда : ["паровая"]
Все : ["ночные","ночные гости"]
Все ночные : ["гости"]
Всего : ["лучшего","хорошего","лучшего Анна","хорошего Исай"]
Всего лучшего : ["Анна"]
Всего хорошего : ["Исай"]
Всем : ["известно","известно что"]
Всем известно : ["что"]
Вчера : ["здесь","здесь как"]
Вчера здесь : ["как"]
Вы : ["вникните","понимаете","бы","вникните в","понимаете всетаки","бы лучше"]
Вы бы : ["лучше"]
Вы вникните : ["в"]
Вы понимаете : ["всетаки"]
Глаза : ["у","у нее"]
Глаза у : ["нее"]
Господи : ["и","и без"]
Господи и : ["без"]
Господин : ["Кербеш","Кербеш но","Кербеш я"]
Господин Кербеш : ["но","я"]
Да : ["и","ведь","да","и остальные","ведь я","да да"]
Да ведь : ["я"]
Да да : ["да"]
Да и : ["остальные"]
Давнымдавно : ["задолго","задолго до"]
Давнымдавно задолго : ["до"]
Два : ["часа","часа дня"]
Два часа : ["дня"]
Девицы : ["по","покамест","по традиции","покамест еще"]
Девицы по : ["традиции"]
Девицы покамест : ["еще"]
Девушка : ["была","была обманным"]
Девушка была : ["обманным"]
До : ["самого","свиданья","самого утра"]
До самого : ["утра"]
Дом : ["двухэтажный","двухэтажный зеленый"]
Дом двухэтажный : ["зеленый"]
Другую : ["зовут","зовут Зося"]
Другую зовут : ["Зося"]
Ее : ["муж","муж Исай"]
Ее муж : ["Исай"]
Ей : ["лет","лет под"]
Ей лет : ["под"]
Ейбогу : ["она","Анночка","она здесь","Анночка вся"]
Ейбогу Анночка : ["вся"]
Ейбогу она : ["здесь"]
Застоявшийся : ["неподвижный","неподвижный воздух"]
Застоявшийся неподвижный : ["воздух"]
Затем : ["две","две экономки"]
Затем две : ["экономки"]
Заходите : []
Здесь : ["бывают","бывают все"]
Здесь бывают : ["все"]
Зося : []
И : ["женщины","так","вся","со","это","какие","вдруг","пусть","ни","женщины с","так без","вся улица","со странным","это гораздо","какие тут","вдруг она","пусть пеняют","ни на"]
И вдруг : ["она"]
И вся : ["улица"]
И женщины : ["с"]
И какие : ["тут"]
И ни : ["на"]
И пусть : ["пеняют"]
И со : ["странным"]
И так : ["без"]
И это : ["гораздо"]
Имею : ["честь"]
Иногда : ["внимательно","внимательно и"]
Иногда внимательно : ["и"]
Исай : ["Саввич","Саввич тоже"]
Исай Саввич : ["тоже"]
К : ["концу","рассвету","Эмме","концу XIX","рассвету Яма","Эмме Эдуардовне"]
К Эмме : ["Эдуардовне"]
К концу : ["XIX"]
К рассвету : ["Яма"]
Как : ["смеешь"]
Както : ["само","само собою"]
Както само : ["собою"]
Кербеш : ["медленно","но","я","медленно втягивает","но ведь","я попрошу"]
Кербеш медленно : ["втягивает"]
Кербеш но : ["ведь"]
Кербеш я : ["попрошу"]
Кербеша : ["хрустит","хрустит в"]
Кербеша хрустит : ["в"]
Когда : ["его","его шаги"]
Когда его : ["шаги"]
Компания : ["из","из пяти"]
Компания из : ["пяти"]
Конечно : ["ваше","ваше дело"]
Конечно ваше : ["дело"]
Круглый : ["год","год всякий"]
Круглый год : ["всякий"]
Куда : ["мы","мы только"]
Куда мы : ["только"]
Лицо : ["расширяется","расширяется грушей"]
Лицо расширяется : ["грушей"]
Любка : ["босая","босая в"]
Любка босая : ["в"]
Маковского : ["«Боярский","«Боярский пир»"]
Маковского «Боярский : ["пир»"]
Малая : ["Ямская","Ямская оказались"]
Малая Ямская : ["оказались"]
Малой : ["Ямской","Ямской которую"]
Малой Ямской : ["которую"]
Марковна : ["служила","удалясь","отвесив","служила здесь","удалясь на","отвесив свою"]
Марковна отвесив : ["свою"]
Марковна служила : ["здесь"]
Марковна удалясь : ["на"]
Марковны : ["несколько","все","несколько поплоше","все погружено"]
Марковны все : ["погружено"]
Марковны несколько : ["поплоше"]
Может : ["еще","еще рюмочку"]
Может еще : ["рюмочку"]
Мы : ["хотим","нашу","хотим немножко","нашу Берточку"]
Мы нашу : ["Берточку"]
Мы хотим : ["немножко"]
На : ["улице","улице точно"]
На улице : ["точно"]
Наконец : ["пятое","след","пятое лицо","след находится"]
Наконец пятое : ["лицо"]
Наконец след : ["находится"]
Наступает : ["самый","самый деловой"]
Наступает самый : ["деловой"]
Не : ["канцай","могу","канцай строго"]
Не канцай : ["строго"]
Неловкое : ["молчание"]
Нетерпеливо : ["платят","платят вперед"]
Нетерпеливо платят : ["вперед"]
Ни : ["для","для кого"]
Ни для : ["кого"]
Но : ["за","в","она","подобно","он","боже","за Ямой","в зале","она от","подобно тому","он собственно","боже мой","в дверях"]
Но боже : ["мой"]
Но в : ["зале","дверях"]
Но за : ["Ямой"]
Но он : ["собственно"]
Но она : ["от"]
Но подобно : ["тому"]
Ну : ["ты","скажите","и","я","ты болван","скажите ради","и всыпал","я ему"]
Ну и : ["всыпал"]
Ну скажите : ["ради"]
Ну ты : ["болван"]
Ну я : ["ему"]
Образ : ["жизни","жизни нравы"]
Образ жизни : ["нравы"]
Огого : []
Одна : ["из","из девиц"]
Одна из : ["девиц"]
Однако : ["пора","пора и"]
Однако пора : ["и"]
Околоточный : ["поспешно","встает","поспешно допивая","встает и"]
Околоточный встает : ["и"]
Околоточный поспешно : ["допивая"]
Он : ["у","самоучкой","уходит","у жены","самоучкой чтобы"]
Он самоучкой : ["чтобы"]
Он у : ["жены"]
Она : ["торжественно","рано","очень","высокая","только","худощава","попадает","торжественно и","рано встала","очень мала","высокая полная","только что","худощава вертлява","попадает из"]
Она высокая : ["полная"]
Она очень : ["мала"]
Она попадает : ["из"]
Она рано : ["встала"]
Она только : ["что"]
Она торжественно : ["и"]
Она худощава : ["вертлява"]
Оне : ["совершеннолетние","дали","совершеннолетние подтверждает","дали расписку"]
Оне дали : ["расписку"]
Оне совершеннолетние : ["подтверждает"]
Они : ["же","же зажгли"]
Они же : ["зажгли"]
Остальные : ["дома","дома по"]
Остальные дома : ["по"]
Оттого : ["и","и вся"]
Оттого и : ["вся"]
Павел : []
Петя : ["ушел"]
По : ["давнему","давнему обычаю"]
По давнему : ["обычаю"]
Повсеместно : ["разврат","разврат нравственность"]
Повсеместно разврат : ["нравственность"]
Подумайте : ["сами","сами мадам"]
Подумайте сами : ["мадам"]
Покраснеешь : []
Понемногу : ["все","все расползаются"]
Понемногу все : ["расползаются"]
Поэтому : ["девицы","девицы чтут"]
Поэтому девицы : ["чтут"]
Примите : ["деньги","деньги и"]
Примите деньги : ["и"]
Приходит : ["подлец","и","подлец и","и говорит"]
Приходит и : ["говорит"]
Приходит подлец : ["и"]
Приходят : ["свободно","свободно и"]
Приходят свободно : ["и"]
Пришел : ["один","один гость"]
Пришел один : ["гость"]
Провинившихся : ["она","она собственноручно"]
Провинившихся она : ["собственноручно"]
Пьют : ["кофе","кофе с"]
Пьют кофе : ["с"]
Разговор : ["о","о совращенной"]
Разговор о : ["совращенной"]
Расстреливать : ["их","их надо"]
Расстреливать их : ["надо"]
Рука : ["Кербеша","Кербеша хрустит"]
Рука Кербеша : ["хрустит"]
С : ["удовольствием"]
Саввич : ["тоже","тоже маленький"]
Саввич тоже : ["маленький"]
Сама : ["хозяйка","хозяйка на"]
Сама хозяйка : ["на"]
Самое : ["шикарное","шикарное заведение"]
Самое шикарное : ["заведение"]
Сегодня : ["троица"]
Сладко : ["пахнет","пахнет полуувядшей"]
Сладко пахнет : ["полуувядшей"]
Слышно : ["как","как на"]
Слышно как : ["на"]
Софьи : ["Васильевны","Васильевны «СтароКиевский»"]
Софьи Васильевны : ["«СтароКиевский»"]
Спасибо : ["вам","вам за"]
Спасибо вам : ["за"]
Среди : ["девиц","девиц у"]
Среди девиц : ["у"]
Старшая : ["Эмма","Эмма Эдуардовна"]
Старшая Эмма : ["Эдуардовна"]
Странно : []
Так : ["проходит","же","как","проходит вся","же и","как же"]
Так же : ["и"]
Так как : ["же"]
Так проходит : ["вся"]
Теперешний : ["владелец","владелец ее"]
Теперешний владелец : ["ее"]
Теперь : ["улица","она","родители","со","улица пуста","она кормит","родители разыскивают","со мной"]
Теперь она : ["кормит"]
Теперь родители : ["разыскивают"]
Теперь со : ["мной"]
Теперь улица : ["пуста"]
Тихо : ["пусто","пусто и"]
Тихо пусто : ["и"]
Тишина : []
Тонкий : ["женский","женский голос"]
Тонкий женский : ["голос"]
Треппеля : ["при","берут","при въезде","берут за"]
Треппеля берут : ["за"]
Треппеля при : ["въезде"]
Три : ["двухрублевых","двухрублевых заведения"]
Три двухрублевых : ["заведения"]
Тускло : ["поблескивает","поблескивает фортепиано"]
Тускло поблескивает : ["фортепиано"]
У : ["Треппеля","нее","него","Треппеля берут","нее вчера","него на"]
У Треппеля : ["берут"]
У него : ["на"]
У нее : ["вчера"]
Укомплектован : []
Фараон : []
Флейшера : ["мы","мы нарочно"]
Флейшера мы : ["нарочно"]
Фома : ["Фомич"]
Фомич : []
Хозяйка : ["вдруг","вдруг встает"]
Хозяйка вдруг : ["встает"]
Хорошос : []
Хочет : ["и","и здесь"]
Хочет и : ["здесь"]
Частных : ["домов","домов осталось"]
Частных домов : ["осталось"]
Через : ["десять","десять минут"]
Через десять : ["минут"]
Что : ["я","же","ни","я могу","же вы","ни прислуга"]
Что же : ["вы"]
Что ни : ["прислуга"]
Что я : ["могу"]
Чтобы : ["только","только им"]
Чтобы только : ["им"]
Шойбес : ["говорит","это","говорит он","это же"]
Шойбес говорит : ["он"]
Шойбес это : ["же"]
Эдуардовна : ["произносит","которая","фыркает","произносит басом","которая слушала","фыркает носом"]
Эдуардовна которая : ["слушала"]
Эдуардовна произносит : ["басом"]
Эдуардовна фыркает : ["носом"]
Эдуардовне : ["она","она относится"]
Эдуардовне она : ["относится"]
Экономочка : []
Эмма : ["Эдуардовна","Эдуардовна произносит","Эдуардовна которая","Эдуардовна фыркает"]
Эмма Эдуардовна : ["произносит","которая","фыркает"]
Эмме : ["Эдуардовне","Эдуардовне она"]
Эмме Эдуардовне : ["она"]
Это : ["старая","атлетический","же","старая фирма","атлетический человек","же дело"]
Это атлетический : ["человек"]
Это же : ["дело"]
Это старая : ["фирма"]
Я : ["тебе","ему","вас","тебе дам","ему говорю","вас спрашиваю"]
Я вас : ["спрашиваю"]
Я ему : ["говорю"]
Я тебе : ["дам"]
Яма : ["понемногу","понемногу затихает"]
Яма понемногу : ["затихает"]
Ямками : ["или","или еще"]
Ямками или : ["еще"]
Ямой : ["на","на много"]
Ямой на : ["много"]
Ямская : ["оказались","и","оказались занятыми","и Малая"]
Ямская и : ["Малая"]
Ямская оказались : ["занятыми"]
Ямской : ["Ямками","слободой","рублевые","которую","и","Ямками или","слободой или","которую посещают","и что"]
Ямской Ямками : ["или"]
Ямской и : ["что"]
Ямской которую : ["посещают"]
Ямской слободой : ["или"]
Ямскую : ["первый","первый дом"]
Ямскую первый : ["дом"]
Ямы : ["Большая","Большая Ямская"]
Ямы Большая : ["Ямская"]
а : ["следовательно","за","на","также","часть","в","только","следовательно и","за всю","на кроватях","также траурный","часть в","в прошлом","только делает"]
а в : ["прошлом"]
а за : ["всю"]
а на : ["кроватях"]
а следовательно : ["и"]
а также : ["траурный"]
а только : ["делает"]
а часть : ["в"]
авторы : ["горячих","горячих страстных"]
авторы горячих : ["страстных"]
адвокаты : ["и","и строгие"]
адвокаты и : ["строгие"]
аж : ["вся","вся покраснела"]
аж вся : ["покраснела"]
акт : ["половой","половой любви"]
акт половой : ["любви"]
актеров : ["преимущественно","преимущественно толстых"]
актеров преимущественно : ["толстых"]
алкогольных : ["паров","паров и"]
алкогольных паров : ["и"]
анархисты : ["и","и наемные"]
анархисты и : ["наемные"]
атласными : ["пуфами"]
атлетический : ["человек"]
базаре : ["целый","целый воз"]
базаре целый : ["воз"]
байковые : ["одеяла"]
бальные : ["платья","платья опушенные"]
бальные платья : ["опушенные"]
барашком : []
барышень : []
барышни : ["еще","еще спят"]
барышни еще : ["спят"]
басом : ["с","с холодной"]
басом с : ["холодной"]
башмаком : []
беглые : ["каторжники","каторжники и"]
беглые каторжники : ["и"]
бедрами : ["и","и высоко"]
бедрами и : ["высоко"]
без : ["конца","мужчины","промежутков","того","конца день","мужчины и","того неприятностей"]
без конца : ["день"]
без мужчины : ["и"]
без того : ["неприятностей"]
безлично : ["льстиво","льстиво и"]
безлично льстиво : ["и"]
безлюдной : ["просторной","просторной погруженной"]
безлюдной просторной : ["погруженной"]
безносые : ["с","с дряблыми"]
безносые с : ["дряблыми"]
безымянным : ["пальцем","пальцем левой"]
безымянным пальцем : ["левой"]
белое : ["сверканье","сверканье многогранного"]
белое сверканье : ["многогранного"]
белой : ["дорожкой","дорожкой на"]
белой дорожкой : ["на"]
белотелые : ["грудастые","грудастые красивые"]
белотелые грудастые : ["красивые"]
белые : ["с","тонкие","с золотом","тонкие стволики"]
белые с : ["золотом"]
белые тонкие : ["стволики"]
белым : ["выстроен","выстроен в"]
белым выстроен : ["в"]
бенедиктин : ["жалуется","жалуется на"]
бенедиктин жалуется : ["на"]
бенедиктином : []
березками : []
берешь : ["взятки","взятки с"]
берешь взятки : ["с"]
берут : ["за","за визит","за время"]
берут за : ["визит","время"]
бесплодных : ["женщин"]
беспрерывно : ["подъезжают","подъезжают и"]
беспрерывно подъезжают : ["и"]
бессильно : ["мокрой","мокрой нижней"]
бессильно мокрой : ["нижней"]
бесцельно : ["самое","самое великое"]
бесцельно самое : ["великое"]
благовещения : ["когда","когда птица"]
благовещения когда : ["птица"]
благодаря : ["своей","своей страшной"]
благодаря своей : ["страшной"]
блеклоголубые : ["девичьи","девичьи даже"]
блеклоголубые девичьи : ["даже"]
блеклоголубым : ["глазом"]
блеклые : ["глаза"]
блеске : ["летнего","летнего солнца"]
блеске летнего : ["солнца"]
блестящей : ["шерстью","шерстью и"]
блестящей шерстью : ["и"]
блюдо : ["для","для визитных"]
блюдо для : ["визитных"]
блюстители : ["нравственности","нравственности педагоги"]
блюстители нравственности : ["педагоги"]
бога : ["мадам","мадам Шойбес"]
бога мадам : ["Шойбес"]
богатой : ["семидесятилетней","семидесятилетней старухе"]
богатой семидесятилетней : ["старухе"]
боже : ["мой","мой куда"]
боже мой : ["куда"]
боком : ["слабо","слабо светятся"]
боком слабо : ["светятся"]
болван : []
более : ["или","не","или менее","не возобновляется"]
более или : ["менее"]
более не : ["возобновляется"]
болотной : ["травы"]
больные : ["и","и здоровые"]
больные и : ["здоровые"]
больше : ["пятишести","не","пятишести но","не было","не сын"]
больше не : ["было","сын"]
больше пятишести : ["но"]
большей : ["части","части хриплы"]
большей части : ["хриплы"]
большинство : ["из","из них"]
большинство из : ["них"]
большого : ["южного","южного города"]
большого южного : ["города"]
большой : ["нежилой","средний","нежилой комнаты","средний и"]
большой нежилой : ["комнаты"]
большой средний : ["и"]
борнотимоловым : ["мылом","мылом и"]
борнотимоловым мылом : ["и"]
борода : ["веером","веером яркосиние"]
борода веером : ["яркосиние"]
бородатые : ["отцы","отцы семейств"]
бородатые отцы : ["семейств"]
босая : ["в","в сорочке"]
босая в : ["сорочке"]
бретеры : ["не","не чувствовали"]
бретеры не : ["чувствовали"]
брюхатые : ["геморроидальные","геморроидальные обезьяны"]
брюхатые геморроидальные : ["обезьяны"]
будничный : ["час"]
будут : ["готовиться","готовиться к"]
будут готовиться : ["к"]
буйные : ["замашки","замашки и"]
буйные замашки : ["и"]
бы : ["лучше","лучше пошли"]
бы лучше : ["пошли"]
бывает : ["среди","среди дня"]
бывает среди : ["дня"]
бывают : ["все"]
был : ["вчера","швейцаром","грозою","третьего","вчера натерт","швейцаром в","грозою жуликов","третьего дня"]
был вчера : ["натерт"]
был грозою : ["жуликов"]
был третьего : ["дня"]
был швейцаром : ["в"]
была : ["обманным","обманным образом"]
была обманным : ["образом"]
было : ["только","иначе","только шесть","иначе папа"]
было иначе : ["папа"]
было только : ["шесть"]
быть : ["чемнибудь","чемнибудь полезным"]
быть чемнибудь : ["полезным"]
бьет : ["жестоко","бьет","жестоко холодно","бьет жестоко"]
бьет бьет : ["жестоко"]
бьет жестоко : ["холодно"]
в : ["род","ночную","них","некоторых","плате","пышности","сравнительной","подборе","ложнорусском","протянутых","передней","золоченых","танцевальном","спальнях","дорогие","открытые","зале","матросские","цветное","золотых","ресторан","общем","ту","сон","своих","тишине","блеске","пустых","ней","кабинетах","коридорах","русском","веснушках","сорочке","кухне","десять","друга","этом","рассрочку","доме","прошлом","своей","своем","себя","это","как","дом","десятое","другое","моем","мое","кармане","почтенном","городе","гимназии","дверях","род ямщики","ночную пору","них помещаются","некоторых внешних","плате взимаемой","пышности помещения","сравнительной нарядности","подборе более","ложнорусском ёрническом","протянутых лапах","передней чучело","золоченых рамах","танцевальном зале","спальнях голубые","дорогие маскарадные","открытые бальные","зале кривой","матросские костюмы","цветное ситцевое","золотых очках","ресторан или","общем зале","ту же","сон с","своих публичных","тишине и","блеске летнего","пустых театрах","ней темно","зале спущены","кабинетах в","коридорах в","русском стиле","веснушках но","сорочке с","кухне пол","десять часов","друга без","ту пору","этом же","рассрочку по","доме не","прошлом году","своей пестрой","своем прошлом","себя полрюмки","как его","дом терпимости","другое из","моем околотке","мое положение","кармане новенькой","почтенном семействе","городе в","гимназии Флейшера","дверях он"]
в блеске : ["летнего"]
в веснушках : ["но"]
в гимназии : ["Флейшера"]
в городе : ["в"]
в дверях : ["он"]
в десять : ["часов"]
в дом : ["терпимости"]
в доме : ["не"]
в дорогие : ["маскарадные"]
в друга : ["без"]
в другое : ["из"]
в зале : ["кривой","спущены"]
в золотых : ["очках"]
в золоченых : ["рамах"]
в кабинетах : ["в"]
в как : ["его"]
в кармане : ["новенькой"]
в коридорах : ["в"]
в кухне : ["пол"]
в ложнорусском : ["ёрническом"]
в матросские : ["костюмы"]
в мое : ["положение"]
в моем : ["околотке"]
в ней : ["темно"]
в некоторых : ["внешних"]
в них : ["помещаются"]
в ночную : ["пору"]
в общем : ["зале"]
в открытые : ["бальные"]
в передней : ["чучело"]
в плате : ["взимаемой"]
в подборе : ["более"]
в почтенном : ["семействе"]
в протянутых : ["лапах"]
в прошлом : ["году"]
в пустых : ["театрах"]
в пышности : ["помещения"]
в рассрочку : ["по"]
в ресторан : ["или"]
в род : ["ямщики"]
в русском : ["стиле"]
в своей : ["пестрой"]
в своем : ["прошлом"]
в своих : ["публичных"]
в себя : ["полрюмки"]
в сон : ["с"]
в сорочке : ["с"]
в спальнях : ["голубые"]
в сравнительной : ["нарядности"]
в танцевальном : ["зале"]
в тишине : ["и"]
в ту : ["же","пору"]
в цветное : ["ситцевое"]
в этом : ["же"]
валяются : ["скомканные","скомканные коекак"]
валяются скомканные : ["коекак"]
вам : ["только","за","только слово","за компанию"]
вам за : ["компанию"]
вам только : ["слово"]
вас : ["и","поглядеть","на","понимаю","спрашиваю","и главное","поглядеть на","на всех","спрашиваю чего"]
вас и : ["главное"]
вас на : ["всех"]
вас поглядеть : ["на"]
вас спрашиваю : ["чего"]
ваше : ["дело","дело но"]
ваше дело : ["но"]
вверх : ["пары","три","пары мужчин","три мягких"]
вверх пары : ["мужчин"]
вверх три : ["мягких"]
вверху : ["и","и белое"]
вверху и : ["белое"]
вдовы : ["тайно","тайно торговали"]
вдовы тайно : ["торговали"]
вдоль : ["стен","стен белые","стен с"]
вдоль стен : ["белые","с"]
вдруг : ["встает","она","встает шаркает","она из"]
вдруг встает : ["шаркает"]
вдруг она : ["из"]
ведь : ["она","я","она же","я не"]
ведь она : ["же"]
ведь я : ["не"]
веером : ["яркосиние","яркосиние сонные"]
веером яркосиние : ["сонные"]
векселю : []
великое : ["и","и прекрасное"]
великое и : ["прекрасное"]
вертлява : ["чуть","чуть косенькая"]
вертлява чуть : ["косенькая"]
веселая : ["музыка","музыка скрипок"]
веселая музыка : ["скрипок"]
веселыми : ["танцуют","танцуют выделывая"]
веселыми танцуют : ["выделывая"]
веснушках : ["но","но крепкая"]
веснушках но : ["крепкая"]
весь : ["волнуясь","волнуясь спиной"]
весь волнуясь : ["спиной"]
вечер : ["за","горели","за исключением","горели огни"]
вечер горели : ["огни"]
вечер за : ["исключением"]
вечерам : ["играет","играет танцы"]
вечерам играет : ["танцы"]
вечером : ["женщины","было","женщины проснутся","было только"]
вечером было : ["только"]
вечером женщины : ["проснутся"]
вздыхает : ["Анна","Анна Марковна"]
вздыхает Анна : ["Марковна"]
взимаемой : ["за","за кратковременную"]
взимаемой за : ["кратковременную"]
взятки : ["с","с публичных"]
взятки с : ["публичных"]
взять : ["деньги"]
вид : ["что","что делает"]
вид что : ["делает"]
видами : ["порока"]
видели : ["коечто","коечто в"]
видели коечто : ["в"]
видеть : []
видны : ["с","с улицы"]
видны с : ["улицы"]
визит : ["три","три рубля"]
визит три : ["рубля"]
визитных : ["карточек"]
висячие : ["красные","красные фонари"]
висячие красные : ["фонари"]
вихряя : ["бедрами","бедрами и"]
вихряя бедрами : ["и"]
владелец : ["ее","ее носит"]
владелец ее : ["носит"]
власти : ["над","над собакой"]
власти над : ["собакой"]
влево : []
влюбленные : ["женихи","женихи и"]
влюбленные женихи : ["и"]
вмешивается : ["суетливо","суетливо Зося"]
вмешивается суетливо : ["Зося"]
внешних : ["мелочах"]
вниз : ["к","к щекам"]
вниз к : ["щекам"]
вникните : ["в","в мое"]
вникните в : ["мое"]
внимательно : ["и","и долго"]
внимательно и : ["долго"]
внутренний : ["двор"]
во : ["всех","всем","внутренний","всех тридцати","всех домах","всем доме","внутренний двор"]
во внутренний : ["двор"]
во всем : ["доме"]
во всех : ["тридцати","домах"]
вовлечена : ["в","в это"]
вовлечена в : ["это"]
водкой : ["и","и свободной"]
водкой и : ["свободной"]
воз : ["осоки","осоки и"]
воз осоки : ["и"]
возбуждений : ["и","и мальчики"]
возбуждений и : ["мальчики"]
возбуждения : []
возвращаются : ["не","не глядя"]
возвращаются не : ["глядя"]
воздух : ["кислый","еще","кислый и","еще хранит"]
воздух еще : ["хранит"]
воздух кислый : ["и"]
возобновляется : []
вокзал : ["сидят","сидят курят"]
вокзал сидят : ["курят"]
воле : []
волнению : ["и","и ласке"]
волнению и : ["ласке"]
волнуясь : ["спиной","спиной и"]
волнуясь спиной : ["и"]
вольные : []
вообразив : ["снизу","снизу вверх"]
вообразив снизу : ["вверх"]
вообще : ["народ","народ серый"]
вообще народ : ["серый"]
воришки : ["ремесленники","ремесленники и"]
воришки ремесленники : ["и"]
ворчливо : ["хозяйка"]
воры : ["и","и убийцы"]
воры и : ["убийцы"]
воспоминании : ["о","о своих"]
воспоминании о : ["своих"]
воспоминаниям : ["детства","детства и"]
воспоминаниям детства : ["и"]
вот : ["у","у нас"]
вот у : ["нас"]
впервые : ["женщину","женщину и"]
впервые женщину : ["и"]
вперед : ["деньги","деньги и"]
вперед деньги : ["и"]
вправо : ["и","и влево"]
вправо и : ["влево"]
временем : ["разбитые","разбитые щербатые"]
временем разбитые : ["щербатые"]
времени : ["осталась","пятнистые","осталась темная","пятнистые простыни"]
времени осталась : ["темная"]
времени пятнистые : ["простыни"]
временных : ["гостей","гостей но"]
временных гостей : ["но"]
время : ["пятьдесят","пятьдесят копеек"]
время пятьдесят : ["копеек"]
все : ["окна","погружено","гардины","расползаются","окна ярко","погружено в","гардины и","расползаются из"]
все гардины : ["и"]
все окна : ["ярко"]
все погружено : ["в"]
все расползаются : ["из"]
всегда : ["есть","есть фаворитка"]
всегда есть : ["фаворитка"]
всем : ["доме"]
всеми : ["видами","образами","правами","видами порока","правами и"]
всеми видами : ["порока"]
всеми правами : ["и"]
всетаки : ["неловко","мой","мой совет"]
всетаки мой : ["совет"]
всех : ["тридцати","домах","донесет","тридцати с","домах входные","домах около","донесет начальнику"]
всех домах : ["входные","около"]
всех донесет : ["начальнику"]
всех тридцати : ["с"]
вскидывая : ["ногами","ногами вверх"]
вскидывая ногами : ["вверх"]
встает : ["шаркает","и","шаркает туфлями","и оправляет"]
встает и : ["оправляет"]
встает шаркает : ["туфлями"]
встала : ["в","в десять"]
встала в : ["десять"]
встретят : ["отказа"]
всыпал : ["же","же я"]
всыпал же : ["я"]
всю : ["ночь","ночь десять"]
всю ночь : ["десять"]
вся : ["эта","ночь","улица","покраснела","эта местность","улица сияла","покраснела подтверждает"]
вся покраснела : ["подтверждает"]
вся улица : ["сияла"]
вся эта : ["местность"]
всякий : ["вечер","вечер за"]
всякий вечер : ["за"]
втиснутых : ["друг","друг в"]
втиснутых друг : ["в"]
второстепенном : ["двухрублевом","двухрублевом заведении"]
второстепенном двухрублевом : ["заведении"]
втягивает : ["в","в себя"]
втягивает в : ["себя"]
входные : ["двери","двери открыты"]
входные двери : ["открыты"]
вчера : ["натерт","вечером","натерт паркет","вечером было"]
вчера вечером : ["было"]
вчера натерт : ["паркет"]
вчерашний : ["запах"]
вчерашних : ["побоев","побоев и"]
вчерашних побоев : ["и"]
въезде : ["на","на Большую"]
въезде на : ["Большую"]
вы : ["думаете","эту","эту девицу"]
вы эту : ["девицу"]
выбилась : ["из","из рядовых"]
выбилась из : ["рядовых"]
выбирают : ["любую","любую женщину"]
выбирают любую : ["женщину"]
выброшенные : ["обществом","обществом проклятые"]
выброшенные обществом : ["проклятые"]
выделывая : ["гнусные","гнусные телодвижения"]
выделывая гнусные : ["телодвижения"]
выеденного : ["яйца","яйца не"]
выеденного яйца : ["не"]
вымыть : ["в","в кухне"]
вымыть в : ["кухне"]
выражаясь : ["высоким","высоким слогом"]
выражаясь высоким : ["слогом"]
выражение : ["лица","лица спокойновластное"]
выражение лица : ["спокойновластное"]
выражения : ["лица","что","что я"]
выражения что : ["я"]
вырастать : ["открытые","открытые публичные"]
вырастать открытые : ["публичные"]
высокая : ["полная","полная шатенка"]
высокая полная : ["шатенка"]
высоким : ["слогом"]
высоко : ["вскидывая","вскидывая ногами"]
высоко вскидывая : ["ногами"]
выспалась : ["одна","и","одна совсем","и провела"]
выспалась и : ["провела"]
выспалась одна : ["совсем"]
выстроен : ["в","в ложнорусском"]
выстроен в : ["ложнорусском"]
выучился : ["играть","играть на"]
выучился играть : ["на"]
вышла : ["во","во внутренний"]
вышла во : ["внутренний"]
вьет : ["и","и стриженая"]
вьет и : ["стриженая"]
гардины : ["и","и оттого"]
гардины и : ["оттого"]
гаремах : ["странной","странной неправдоподобной"]
гаремах странной : ["неправдоподобной"]
где : ["раньше","берут","раньше румяные","берут за"]
где берут : ["за"]
где раньше : ["румяные"]
геморроидальные : ["обезьяны"]
геморроидальными : ["кругами"]
гимназии : ["Флейшера","приносит","Флейшера мы","приносит такие"]
гимназии Флейшера : ["мы"]
гимназии приносит : ["такие"]
гимназист : ["Павел"]
гимназисток : ["и","и большинство"]
гимназисток и : ["большинство"]
гимназисты : ["почти","почти дети"]
гимназисты почти : ["дети"]
главное : ["подумайте"]
глаза : ["у","маленькие","и","у нее","маленькие черные","и тонкий"]
глаза и : ["тонкий"]
глаза маленькие : ["черные"]
глаза у : ["нее"]
глазом : []
гласным : ["городской","городской думы"]
гласным городской : ["думы"]
глупых : ["ленивых","ленивых истеричных"]
глупых ленивых : ["истеричных"]
глухими : ["ставнями","ставнями на"]
глухими ставнями : ["на"]
глухонемые : ["слепые","слепые безносые"]
глухонемые слепые : ["безносые"]
глядя : ["на","друг","на стол","друг на"]
глядя друг : ["на"]
глядя на : ["стол"]
глядят : ["на","на темное"]
глядят на : ["темное"]
глянцевитым : ["боком","боком слабо"]
глянцевитым боком : ["слабо"]
гнезд : ["где","где раньше"]
гнезд где : ["раньше"]
гнезда : ["не","не вьет"]
гнезда не : ["вьет"]
гнусавы : ["с","с полупровалившимися"]
гнусавы с : ["полупровалившимися"]
гнусные : ["телодвижения","телодвижения имитирующие"]
гнусные телодвижения : ["имитирующие"]
говорит : ["он","хозяйка","мигая","по","многозначительно","презрительно","он глядя","мигая околоточному","по ту"]
говорит мигая : ["околоточному"]
говорит он : ["глядя"]
говорит по : ["ту"]
говорю : ["досадливо","досадливо морщится"]
говорю досадливо : ["морщится"]
год : ["всякий","через","всякий вечер","через два"]
год всякий : ["вечер"]
год через : ["два"]
года : ["тому","тому назад"]
года тому : ["назад"]
году : ["задушил","задушил ее"]
году задушил : ["ее"]
годы : ["живут","живут они"]
годы живут : ["они"]
голова : []
головой : []
голову : ["к","к земле"]
голову к : ["земле"]
голос : ["говорит","говорит по"]
голос говорит : ["по"]
голубые : ["и","и розовые"]
голубые и : ["розовые"]
голыми : ["руками","руками некрасивая"]
голыми руками : ["некрасивая"]
гораздо : ["тяжелее","тяжелее чем"]
гораздо тяжелее : ["чем"]
горбатый : ["нос","нос строго"]
горбатый нос : ["строго"]
горели : ["огни","огни звенела"]
горели огни : ["звенела"]
горит : ["в","в блеске"]
горит в : ["блеске"]
горничные : ["заведения","заведения ранним"]
горничные заведения : ["ранним"]
город : ["знает","знает что"]
город знает : ["что"]
города : ["жили","жили из"]
города жили : ["из"]
городе : ["в","в почтенном"]
городе в : ["почтенном"]
городского : ["сладострастия","сладострастия оберегательницы"]
городского сладострастия : ["оберегательницы"]
городской : ["думы","думы и"]
городской думы : ["и"]
горячих : ["страстных","страстных статей"]
горячих страстных : ["статей"]
горячо : ["соглашается","соглашается околоточный"]
горячо соглашается : ["околоточный"]
гостей : ["но","но на"]
гостей но : ["на"]
гости : ["уже","уже разъехались"]
гости уже : ["разъехались"]
гостис : []
гость : ["толстый","толстый человек"]
гость толстый : ["человек"]
готовиться : ["к","к следующей"]
готовиться к : ["следующей"]
готовностью : ["с","с однообразными"]
готовностью с : ["однообразными"]
грозою : ["жуликов","жуликов благодаря"]
грозою жуликов : ["благодаря"]
громкими : ["именами","именами и"]
громкими именами : ["и"]
грубой : ["поспешностью","поспешностью выбирают"]
грубой поспешностью : ["выбирают"]
грудастые : ["красивые","красивые женщины"]
грудастые красивые : ["женщины"]
грушей : ["от","от лба"]
грушей от : ["лба"]
грязно : ["и","и скудно"]
грязно и : ["скудно"]
губой : []
губу : ["и","и затуманив"]
губу и : ["затуманив"]
губы : []
гусаров : ["пажей","пажей рыбачек"]
гусаров пажей : ["рыбачек"]
да : ["я","да","я вас","да я"]
да да : ["я"]
да я : ["вас"]
давнему : ["обычаю","обычаю горничные"]
давнему обычаю : ["горничные"]
даже : ["до","членом","детские","до сего","членом управы","детские но"]
даже детские : ["но"]
даже до : ["сего"]
даже членом : ["управы"]
дали : ["расписку","расписку что"]
дали расписку : ["что"]
дальней : ["окраине","окраине большого"]
дальней окраине : ["большого"]
дам : []
два : ["кабинета","Анна","года","кабинета с","Анна Марковна","года тому"]
два Анна : ["Марковна"]
два года : ["тому"]
два кабинета : ["с"]
две : ["экономки","экономки старшая"]
две экономки : ["старшая"]
дверей : ["красуются","красуются снаружи"]
дверей красуются : ["снаружи"]
двери : ["открыты","открыты настежь"]
двери открыты : ["настежь"]
дверь : ["стучат","Эмма","Эмма Эдуардовна"]
дверь Эмма : ["Эдуардовна"]
дверям : ["и","и говорит"]
дверям и : ["говорит"]
дверями : ["с","с глухими"]
дверями с : ["глухими"]
дверях : ["он","он останавливается"]
дверях он : ["останавливается"]
движениями : ["удовлетворяют","удовлетворяют как"]
движениями удовлетворяют : ["как"]
двор : []
дворе : ["стемнеет","стемнеет зажигаются"]
дворе стемнеет : ["зажигаются"]
дворник : ["украсил","украсил резной"]
дворник украсил : ["резной"]
двумя : ["десятками","срубленными","десятками плюшевых","срубленными березками"]
двумя десятками : ["плюшевых"]
двумя срубленными : ["березками"]
двухрублевом : ["заведении","заведении Анны"]
двухрублевом заведении : ["Анны"]
двухрублевых : ["заведения","заведения Софьи"]
двухрублевых заведения : ["Софьи"]
двухэтажный : ["зеленый","зеленый с"]
двухэтажный зеленый : ["с"]
девиц : ["Любка","у","Любка босая","у нее"]
девиц Любка : ["босая"]
девиц у : ["нее"]
девицу : ["лучше","лучше сплавьте"]
девицу лучше : ["сплавьте"]
девицы : ["чтут","только","чтут ее","только и"]
девицы только : ["и"]
девицы чтут : ["ее"]
девичьи : ["даже","даже детские"]
девичьи даже : ["детские"]
девка : ["косы","косы не"]
девка косы : ["не"]
девушке : ["более","более не"]
девушке более : ["не"]
девушку : ["передними","передними лапами"]
девушку передними : ["лапами"]
дел : []
делает : ["одолжение","вид","вид что"]
делает вид : ["что"]
делать : ["своими","своими оскверненными"]
делать своими : ["оскверненными"]
дело : ["выеденного","но","выеденного яйца","но как"]
дело выеденного : ["яйца"]
дело но : ["как"]
деловой : ["тихий","тихий будничный"]
деловой тихий : ["будничный"]
день : ["за","за днем"]
день за : ["днем"]
деньги : ["и","и на","и пожалуйте"]
деньги и : ["на","пожалуйте"]
деревянное : ["блюдо","блюдо для"]
деревянное блюдо : ["для"]
деревянными : ["же","полотенцами","же кружевами","полотенцами окаймленными"]
деревянными же : ["кружевами"]
деревянными полотенцами : ["окаймленными"]
держащее : ["в","в протянутых"]
держащее в : ["протянутых"]
держим : ["ее","ее в"]
держим ее : ["в"]
десятками : ["плюшевых","плюшевых стульев"]
десятками плюшевых : ["стульев"]
десятого : ["мужчину","мужчину нередко"]
десятого мужчину : ["нередко"]
десятое : []
десять : ["часов","минут","часов и","минут оба"]
десять минут : ["оба"]
десять часов : ["и"]
дети : []
детские : ["но","но рот"]
детские но : ["рот"]
детства : ["и","и сверкающему"]
детства и : ["сверкающему"]
диванами : ["и","и мягкими"]
диванами и : ["мягкими"]
директору : ["чтобы","чтобы этого"]
директору чтобы : ["этого"]
длинной : ["блестящей","блестящей шерстью"]
длинной блестящей : ["шерстью"]
длинную : ["хрустящую","хрустящую под"]
длинную хрустящую : ["под"]
для : ["визитных","избытка","загулявших","кого","барышень","визитных карточек","избытка городского","загулявших приказчиков","кого в"]
для визитных : ["карточек"]
для загулявших : ["приказчиков"]
для избытка : ["городского"]
для кого : ["в"]
дней : ["страстной","страстной недели"]
дней страстной : ["недели"]
днем : ["месяцы","месяцы и"]
днем месяцы : ["и"]
дню : ["который","который ей"]
дню который : ["ей"]
дня : ["в","случай","в пустых","случай вмешивается"]
дня в : ["пустых"]
дня случай : ["вмешивается"]
до : ["железных","сего","потолка","утра","железных дорог","сего времени","потолка а","утра людьми"]
до железных : ["дорог"]
до потолка : ["а"]
до сего : ["времени"]
до утра : ["людьми"]
добиться : ["эти","эти революционеры"]
добиться эти : ["революционеры"]
доброй : ["воле"]
долго : ["иногда","иногда с"]
долго иногда : ["с"]
дом : ["налево","Анна","терпимости","Анна Марковна","терпимости выражаясь"]
дом Анна : ["Марковна"]
дом терпимости : ["выражаясь"]
дома : ["разрешенные","по","разрешенные начальством","по Большой"]
дома по : ["Большой"]
дома разрешенные : ["начальством"]
домами : ["терпимости"]
домах : ["входные","около","входные двери","около крылец"]
домах входные : ["двери"]
домах около : ["крылец"]
доме : ["еще","не","темно","еще в","не тайна"]
доме еще : ["в"]
доме не : ["тайна"]
домов : ["осталось","Эмма","осталось не","Эмма Эдуардовна"]
домов Эмма : ["Эдуардовна"]
домов осталось : ["не"]
домов» : []
домом : ["над","над шатровыми"]
домом над : ["шатровыми"]
донесет : ["начальнику","начальнику края»"]
донесет начальнику : ["края»"]
доносится : ["сквозь","сквозь стекла"]
доносится сквозь : ["стекла"]
допивая : ["бенедиктин","бенедиктин жалуется"]
допивая бенедиктин : ["жалуется"]
допросах : []
дорог : ["на","на самой"]
дорог на : ["самой"]
дорогие : ["маскарадные","маскарадные костюмы"]
дорогие маскарадные : ["костюмы"]
дорожкой : ["на","на лестнице"]
дорожкой на : ["лестнице"]
дорожку : []
досадливо : ["морщится","морщится околоточный"]
досадливо морщится : ["околоточный"]
достающими : ["до","до потолка"]
достающими до : ["потолка"]
дочь : []
дразня : ["его","его мясом"]
дразня его : ["мясом"]
драчливом : ["и","и в"]
драчливом и : ["в"]
друг : ["в","на","в друга","на друга"]
друг в : ["друга"]
друг на : ["друга"]
друга : ["без","без промежутков"]
друга без : ["промежутков"]
другим : ["занятиям","занятиям распалось"]
другим занятиям : ["распалось"]
другого : ["сына»"]
другое : ["из","из пятого"]
другое из : ["пятого"]
другую : ["сторону","фамилию","сторону исключительно","фамилию и"]
другую сторону : ["исключительно"]
другую фамилию : ["и"]
дряблыми : ["отвислыми","отвислыми телами"]
дряблыми отвислыми : ["телами"]
думаете : []
думают : ["что","что о"]
думают что : ["о"]
думы : ["и","и даже"]
думы и : ["даже"]
духами : ["табаком","табаком кислой"]
духами табаком : ["кислой"]
души : ["рада","рада волнению"]
души рада : ["волнению"]
дым : ["носились","носились вихряя"]
дым носились : ["вихряя"]
дырявые : ["байковые","байковые одеяла"]
дырявые байковые : ["одеяла"]
дыханием : ["плешивые","плешивые трясущиеся"]
дыханием плешивые : ["трясущиеся"]
его : ["мясом","шаги","мясом кричит","шаги затихают"]
его мясом : ["кричит"]
его шаги : ["затихают"]
едва : ["только","только на"]
едва только : ["на"]
ее : ["носит","безлюдной","длинную","можно","юбка","наравне","безлично","запивает","через","в","на","носит совсем","безлюдной просторной","длинную хрустящую","можно себе","юбка торс","наравне с","безлично льстиво","запивает не","через полицию","в городе","на жаргоне"]
ее безлично : ["льстиво"]
ее безлюдной : ["просторной"]
ее в : ["городе"]
ее длинную : ["хрустящую"]
ее запивает : ["не"]
ее можно : ["себе"]
ее на : ["жаргоне"]
ее наравне : ["с"]
ее носит : ["совсем"]
ее через : ["полицию"]
ее юбка : ["торс"]
ей : ["так","заведение","так редко","заведение со"]
ей заведение : ["со"]
ей так : ["редко"]
ему : ["както","говорю","по","еще","както удалось","по первое","еще покажу"]
ему еще : ["покажу"]
ему както : ["удалось"]
ему по : ["первое"]
есть : ["два","фаворитка","два кабинета","фаворитка которую"]
есть два : ["кабинета"]
есть фаворитка : ["которую"]
еще : ["короче","хуже","не","хранит","спят","в","называют","покажу","рюмочку","короче Ямой","хуже обставлены","не остывшей","хранит вчерашний","спят купили","в ту","называют ее","рюмочку на"]
еще в : ["ту"]
еще короче : ["Ямой"]
еще называют : ["ее"]
еще не : ["остывшей"]
еще рюмочку : ["на"]
еще спят : ["купили"]
еще хранит : ["вчерашний"]
еще хуже : ["обставлены"]
жаждущих : ["пьяных","пьяных слез"]
жаждущих пьяных : ["слез"]
жалуется : ["на","на нынешнее"]
жалуется на : ["нынешнее"]
жаргоне : ["публичных","публичных домов"]
жаргоне публичных : ["домов"]
ждущего : ["своей","своей очереди"]
ждущего своей : ["очереди"]
же : ["кружевами","словами","ночь","после","зажгли","и","доме","Фома","дело","совершеннолетняя","не","вы","я","словами улыбками","ночь с","после них","зажгли лампады","и во","доме еще","Фома Фомич","дело выеденного","совершеннолетняя говорит","не нахальство","вы думаете","я ему"]
же Фома : ["Фомич"]
же вы : ["думаете"]
же дело : ["выеденного"]
же доме : ["еще"]
же зажгли : ["лампады"]
же и : ["во"]
же не : ["нахальство"]
же ночь : ["с"]
же после : ["них"]
же словами : ["улыбками"]
же совершеннолетняя : ["говорит"]
же я : ["ему"]
желаниям : ["чтобы","чтобы тотчас"]
желаниям чтобы : ["тотчас"]
железных : ["дорог","дорог на"]
железных дорог : ["на"]
желтой : ["мастики","мастики которой"]
желтой мастики : ["которой"]
желтые : ["старые","старые изъеденные"]
желтые старые : ["изъеденные"]
женился : ["на","на богатой"]
женился на : ["богатой"]
женихи : ["и","и почтенные"]
женихи и : ["почтенные"]
женский : ["голос","голос говорит"]
женский голос : ["говорит"]
женского : ["тела","тела пудрой"]
женского тела : ["пудрой"]
женском : ["равноправии","равноправии и"]
женском равноправии : ["и"]
женщин : ["в","в сравнительной"]
женщин в : ["сравнительной"]
женщину : ["и","и старые","и знают"]
женщину и : ["старые","знают"]
женщины : ["одетые","с","проснутся","одетые в","с равнодушной","проснутся и"]
женщины одетые : ["в"]
женщины проснутся : ["и"]
женщины с : ["равнодушной"]
жены : ["под","под башмаком"]
жены под : ["башмаком"]
жертвах : ["так","так и"]
жертвах так : ["и"]
жертвы : ["общественного","общественного темперамента"]
жертвы общественного : ["темперамента"]
жестами : ["принять","принять третьего"]
жестами принять : ["третьего"]
жестоко : ["холодно","холодно и"]
жестоко холодно : ["и"]
жестокости : ["при","при допросах"]
жестокости при : ["допросах"]
живут : ["они","они в"]
живут они : ["в"]
жидкой : ["умирающей","умирающей зеленью"]
жидкой умирающей : ["зеленью"]
жидкость : ["проглатывает","проглатывает ее"]
жидкость проглатывает : ["ее"]
жизни : ["нравы","нравы и"]
жизни нравы : ["и"]
жизнью : ["выброшенные","выброшенные обществом"]
жизнью выброшенные : ["обществом"]
жилами : ["и","и обрезками"]
жилами и : ["обрезками"]
жили : ["из","из рода"]
жили из : ["рода"]
жирным : ["зобом","зобом из"]
жирным зобом : ["из"]
жирными : ["топлеными","топлеными сливками"]
жирными топлеными : ["сливками"]
жуликов : ["благодаря","благодаря своей"]
жуликов благодаря : ["своей"]
за : ["Ямой","кратковременную","всю","визит","время","исключением","днем","ночь","родную","компанию","ним","Ямой на","кратковременную любовь","всю ночь","визит три","время пятьдесят","исключением трех","днем месяцы","ночь руками","родную дочь","ним парадная"]
за Ямой : ["на"]
за визит : ["три"]
за время : ["пятьдесят"]
за всю : ["ночь"]
за днем : ["месяцы"]
за исключением : ["трех"]
за кратковременную : ["любовь"]
за ним : ["парадная"]
за ночь : ["руками"]
за родную : ["дочь"]
заблаговременно : []
заведение : ["Треппеля","со","Треппеля при","со всеми"]
заведение Треппеля : ["при"]
заведение со : ["всеми"]
заведении : ["Анны","Анны Марковны"]
заведении Анны : ["Марковны"]
заведения : ["Софьи","ранним","Софьи Васильевны","ранним утром"]
заведения Софьи : ["Васильевны"]
заведения ранним : ["утром"]
заведениях : ["разница","разница только"]
заведениях разница : ["только"]
завешены : ["красными","красными кумачовыми"]
завешены красными : ["кумачовыми"]
завтраком : ["для","для барышень"]
завтраком для : ["барышень"]
загулявших : ["приказчиков","приказчиков жаждущих"]
загулявших приказчиков : ["жаждущих"]
задолго : ["до","до железных"]
задолго до : ["железных"]
задумчивой : ["строгой","строгой страннопечальной"]
задумчивой строгой : ["страннопечальной"]
задушил : ["ее"]
зажгли : ["лампады","лампады перед"]
зажгли лампады : ["перед"]
зажигаются : ["перед","перед каждым"]
зажигаются перед : ["каждым"]
закрытыми : ["дверями","дверями с"]
закрытыми дверями : ["с"]
зала : ["с","с зеркалами"]
зала с : ["зеркалами"]
зале : ["паркет","кривой","спущены","паркет на","кривой облупленный","спущены все"]
зале кривой : ["облупленный"]
зале паркет : ["на"]
зале спущены : ["все"]
замашки : ["и","и молодецкие"]
замашки и : ["молодецкие"]
замять : ["это","это дело"]
замять это : ["дело"]
занавеси : ["и","и тюль"]
занавеси и : ["тюль"]
занозистый : ["окна","окна завешены"]
занозистый окна : ["завешены"]
занятиям : ["распалось","распалось и"]
занятиям распалось : ["и"]
занятыми : ["сплошь","сплошь и"]
занятыми сплошь : ["и"]
запах : ["увядающей","увядающей болотной"]
запах увядающей : ["болотной"]
запаха : ["человеческих","человеческих извержений"]
запаха человеческих : ["извержений"]
запахам : ["запах","запах увядающей"]
запахам запах : ["увядающей"]
запивает : ["не","не торопясь"]
запивает не : ["торопясь"]
записан : ["дом","дом Анна"]
записан дом : ["Анна"]
заплетает : ["едва","едва только"]
заплетает едва : ["только"]
зарождения : ["новой","новой жизни"]
зарождения новой : ["жизни"]
застает : ["ее","ее безлюдной"]
застает ее : ["безлюдной"]
застенчивые : ["и","и наглые"]
застенчивые и : ["наглые"]
затихает : ["и","и светлое"]
затихает и : ["светлое"]
затихают : ["на","на лестнице"]
затихают на : ["лестнице"]
затуманив : ["свои","свои блеклые"]
затуманив свои : ["блеклые"]
заученными : ["профессиональными","профессиональными движениями"]
заученными профессиональными : ["движениями"]
заяви : ["директору","директору чтобы"]
заяви директору : ["чтобы"]
заявляет : []
звенела : ["разудалая","разудалая музыка"]
звенела разудалая : ["музыка"]
здесь : ["как","экономкой","подвергаюсь","и","как и","как за","и там"]
здесь и : ["там"]
здесь как : ["и","за"]
здоровые : ["познающие","познающие впервые"]
здоровые познающие : ["впервые"]
зеленые : ["стены","стены сеней"]
зеленые стены : ["сеней"]
зеленый : ["с","с белым"]
зеленый с : ["белым"]
зеленью : []
земле : ["морщит","морщит нос"]
земле морщит : ["нос"]
землистого : ["цвета"]
зеркала : ["в","в золоченых"]
зеркала в : ["золоченых"]
зеркалами : ["в","в золоченых"]
зеркалами в : ["золоченых"]
злобно : ["исковерканные","исковерканные природой"]
злобно исковерканные : ["природой"]
зловонным : ["дыханием","дыханием плешивые"]
зловонным дыханием : ["плешивые"]
знает : ["что","что два"]
знает что : ["два"]
знакомый : ["предупреждаюс"]
знают : ["наперед","наперед что"]
знают наперед : ["что"]
зобом : ["из","из трех"]
зобом из : ["трех"]
зовут : ["Зося"]
золотом : ["стулья","стулья и"]
золотом стулья : ["и"]
золотых : ["очках","очках и"]
золотых очках : ["и"]
золоченых : ["рамах","рамах с"]
золоченых рамах : ["с"]
и : ["вольные","вся","разбрелось","молодецкие","в","подчиненные","свободной","чернобровые","по","Малая","мелочные","обычаи","роскоши","даже","состоит","деревянными","зеркала","тюль","мягкими","чистые","розовые","большинство","Анны","скудно","меньше","где","вообще","занозистый","дырявые","запаха","чадный","наивно","царапин","стриженая","кануна","уезжают","роялей","сквозь","зеленые","белое","узкий","спускаются","тысячи","гимназисты","мальчики","наемные","анархисты","социалдемократы","студенты","офицеры","беглые","шпионы","сыщики","передовые","строгие","либеральные","убийцы","воры","почтенные","влюбленные","молодожены","старые","здоровые","наглые","уроды","просто","знают","долго","прекрасное","на","жестами","светлое","будут","годы","полумраке","«Купанье»","женщин","высоко","каждый","экипажами","кипела","светом","радостно","помещениях","так","оттого","пылью","нечистого","разбросали","дверей","во","сонно","свежая","столы","с","обрезками","чихает","хвостом","храпя","черной","сверкающему","троице","провела","тому","своей","ласке","маленький","голова","теперь","младшая","землистого","обстановкой","побаиваются","расчетливо","фантастической","фамильярно","прической","тонкий","жестокости","был","остальные","кровавое","эти","влево","потом","щурясь","главное","без","говорит","заявляет","что","у","заяви","всыпал","затуманив","не","выражения","разные","думают","пожалуйте","оправляет","хлопает","там","здесь","вся эта","молодецкие обычаи","в ночную","подчиненные нарочитым","свободной любовью","чернобровые сдобные","по другую","по ту","Малая Ямская","мелочные лавки","в них","в некоторых","обычаи почти","роскоши обстановки","даже членом","состоит гласным","деревянными полотенцами","зеркала в","тюль вдоль","мягкими атласными","чистые подушки","розовые фонари","большинство из","Анны Марковны","меньше совсем","где берут","вообще народ","занозистый окна","дырявые байковые","запаха человеческих","чадный с","наивно раскрашенными","царапин и","стриженая девка","кануна благовещения","уезжают извозчики","роялей доносится","сквозь них","зеленые стены","белое сверканье","узкий коридор","спускаются по","тысячи мужчин","гимназисты почти","мальчики кадеты","наемные патриоты","анархисты и","социалдемократы и","студенты и","офицеры и","беглые каторжники","шпионы и","сыщики и","передовые писатели","строгие блюстители","либеральные адвокаты","убийцы и","воры и","почтенные профессоры","влюбленные женихи","молодожены и","старые развратники","здоровые познающие","наглые больные","уроды злобно","просто как","знают наперед","долго иногда","прекрасное из","на публичной","жестами принять","светлое утро","будут готовиться","годы живут","полумраке кажется","в тишине","«Купанье» с","высоко вскидывая","каждый вечер","кипела до","светом из","радостно горит","помещениях суда","так особенно","оттого в","пылью от","нечистого женского","разбросали ее","дверей красуются","во всех","сонно во","свежая телом","оттого она","с удовольствием","обрезками мяса","чихает от","хвостом пригибает","храпя от","черной мордой","сверкающему солнечному","троице по","провела ночь","тому что","своей минутной","ласке Амура","маленький втиснутых","теперь по","землистого цвета","обстановкой причем","расчетливо не","фантастической ревностью","фамильярно «экономочкой»","прической барашком","тонкий слегка","жестокости при","был грозою","остальные четверо","кровавое в","эти люди","потом проводит","щурясь подумайте","главное подумайте","без того","говорит мигая","что берешь","что служишь","у меня","заяви директору","всыпал же","затуманив свои","не рассказывайте","выражения что","разные там","думают что","не думают","пожалуйте мне","оправляет шашку","на службу","говорит многозначительно","говорит презрительно","хлопает за","там взять","здесь и"]
и «Купанье» : ["с"]
и Анны : ["Марковны"]
и Малая : ["Ямская"]
и анархисты : ["и"]
и беглые : ["каторжники"]
и без : ["того"]
и белое : ["сверканье"]
и большинство : ["из"]
и будут : ["готовиться"]
и был : ["грозою"]
и в : ["ночную","них","некоторых","тишине"]
и влюбленные : ["женихи"]
и во : ["всех"]
и вообще : ["народ"]
и воры : ["и"]
и всыпал : ["же"]
и вся : ["эта"]
и выражения : ["что"]
и высоко : ["вскидывая"]
и где : ["берут"]
и гимназисты : ["почти"]
и главное : ["подумайте"]
и говорит : ["мигая","многозначительно","презрительно"]
и годы : ["живут"]
и даже : ["членом"]
и дверей : ["красуются"]
и деревянными : ["полотенцами"]
и долго : ["иногда"]
и думают : ["что"]
и дырявые : ["байковые"]
и жестами : ["принять"]
и жестокости : ["при"]
и занозистый : ["окна"]
и запаха : ["человеческих"]
и затуманив : ["свои"]
и заяви : ["директору"]
и здесь : ["и"]
и здоровые : ["познающие"]
и зеленые : ["стены"]
и землистого : ["цвета"]
и зеркала : ["в"]
и знают : ["наперед"]
и каждый : ["вечер"]
и кануна : ["благовещения"]
и кипела : ["до"]
и кровавое : ["в"]
и ласке : ["Амура"]
и либеральные : ["адвокаты"]
и маленький : ["втиснутых"]
и мальчики : ["кадеты"]
и мелочные : ["лавки"]
и меньше : ["совсем"]
и молодецкие : ["обычаи"]
и молодожены : ["и"]
и мягкими : ["атласными"]
и на : ["публичной","службу"]
и наглые : ["больные"]
и наемные : ["патриоты"]
и наивно : ["раскрашенными"]
и не : ["рассказывайте","думают"]
и нечистого : ["женского"]
и обрезками : ["мяса"]
и обстановкой : ["причем"]
и обычаи : ["почти"]
и оправляет : ["шашку"]
и остальные : ["четверо"]
и оттого : ["в","она"]
и офицеры : ["и"]
и передовые : ["писатели"]
и по : ["другую","ту"]
и подчиненные : ["нарочитым"]
и пожалуйте : ["мне"]
и полумраке : ["кажется"]
и помещениях : ["суда"]
и потом : ["проводит"]
и почтенные : ["профессоры"]
и прекрасное : ["из"]
и прической : ["барашком"]
и провела : ["ночь"]
и просто : ["как"]
и пылью : ["от"]
и радостно : ["горит"]
и разбросали : ["ее"]
и разные : ["там"]
и расчетливо : ["не"]
и розовые : ["фонари"]
и роскоши : ["обстановки"]
и роялей : ["доносится"]
и с : ["удовольствием"]
и свежая : ["телом"]
и сверкающему : ["солнечному"]
и светлое : ["утро"]
и светом : ["из"]
и свободной : ["любовью"]
и своей : ["минутной"]
и сквозь : ["них"]
и сонно : ["во"]
и состоит : ["гласным"]
и социалдемократы : ["и"]
и спускаются : ["по"]
и старые : ["развратники"]
и стриженая : ["девка"]
и строгие : ["блюстители"]
и студенты : ["и"]
и сыщики : ["и"]
и так : ["особенно"]
и там : ["взять"]
и теперь : ["по"]
и тому : ["что"]
и тонкий : ["слегка"]
и троице : ["по"]
и тысячи : ["мужчин"]
и тюль : ["вдоль"]
и у : ["меня"]
и убийцы : ["и"]
и уезжают : ["извозчики"]
и узкий : ["коридор"]
и уроды : ["злобно"]
и фамильярно : ["«экономочкой»"]
и фантастической : ["ревностью"]
и хвостом : ["пригибает"]
и хлопает : ["за"]
и храпя : ["от"]
и царапин : ["и"]
и чадный : ["с"]
и чернобровые : ["сдобные"]
и черной : ["мордой"]
и чистые : ["подушки"]
и чихает : ["от"]
и что : ["берешь","служишь"]
и шпионы : ["и"]
и щурясь : ["подумайте"]
и эти : ["люди"]
играет : ["танцы","танцы а"]
играет танцы : ["а"]
играть : ["на","на скрипке"]
играть на : ["скрипке"]
идем : []
из : ["рода","них","мировых","окон","девиц","пяти","трех","рядовых","пятого","одного","гимназии","комнаты","рода в","них остзейские","мировых таинств","окон и","девиц Любка","пяти человек","трех подбородков","рядовых барышень","пятого в","одного места","гимназии приносит"]
из гимназии : ["приносит"]
из девиц : ["Любка"]
из мировых : ["таинств"]
из них : ["остзейские"]
из одного : ["места"]
из окон : ["и"]
из пяти : ["человек"]
из пятого : ["в"]
из рода : ["в"]
из рядовых : ["барышень"]
из трех : ["подбородков"]
избытка : ["городского","городского сладострастия"]
избытка городского : ["сладострастия"]
извержений : []
известно : ["что","что он"]
известно что : ["он"]
извоз : ["лихое","лихое ямщичье"]
извоз лихое : ["ямщичье"]
извозчики : []
изогнутым : ["глянцевитым","глянцевитым боком"]
изогнутым глянцевитым : ["боком"]
изъеденные : ["временем","временем разбитые"]
изъеденные временем : ["разбитые"]
или : ["еще","просто","менее","в","гнусавы","на","еще короче","просто Ямской","менее красивых","в дорогие","гнусавы с","в матросские","на вокзал"]
или в : ["дорогие","матросские"]
или гнусавы : ["с"]
или еще : ["короче"]
или менее : ["красивых"]
или на : ["вокзал"]
или просто : ["Ямской"]
им : ["свое","свое удовольствие"]
им свое : ["удовольствие"]
именами : ["и","и воры"]
именами и : ["воры"]
иметь : []
имитирующие : ["акт","акт половой"]
имитирующие акт : ["половой"]
имя : ["записан","записан дом"]
имя записан : ["дом"]
иначе : ["папа","папа на"]
иначе папа : ["на"]
иногда : ["с","с грубой"]
иногда с : ["грубой"]
искательно : ["хозяйка"]
исключением : ["трех","трех последних"]
исключением трех : ["последних"]
исключительно : ["домами","домами терпимости"]
исключительно домами : ["терпимости"]
исковерканные : ["природой","природой глухонемые"]
исковерканные природой : ["глухонемые"]
искусственных : ["возбуждений","возбуждений и"]
искусственных возбуждений : ["и"]
истеричных : ["бесплодных","бесплодных женщин"]
истеричных бесплодных : ["женщин"]
истрепанные : ["всеми","всеми видами"]
истрепанные всеми : ["видами"]
их : ["желаниям","барышни","там","надо","желаниям чтобы","барышни еще"]
их барышни : ["еще"]
их желаниям : ["чтобы"]
ищи : ["себе","себе другого"]
ищи себе : ["другого"]
ищущие : ["искусственных","искусственных возбуждений"]
ищущие искусственных : ["возбуждений"]
к : ["другим","следующей","этим","обеду","земле","щекам","дверям","родителям","другим занятиям","следующей ночи","этим запахам","обеду котлеты","земле морщит","щекам и","дверям и"]
к дверям : ["и"]
к другим : ["занятиям"]
к земле : ["морщит"]
к обеду : ["котлеты"]
к следующей : ["ночи"]
к щекам : ["и"]
к этим : ["запахам"]
кабинета : ["с","с коврами"]
кабинета с : ["коврами"]
кабинетах : ["в","в зале"]
кабинетах в : ["зале"]
кадеты : ["и","и гимназисты"]
кадеты и : ["гимназисты"]
каждый : ["вечер","вечер горели"]
каждый вечер : ["горели"]
каждым : ["домом","домом над"]
каждым домом : ["над"]
кажется : ["непривычно","непривычно задумчивой"]
кажется непривычно : ["задумчивой"]
казенные : ["и","и вольные"]
казенные и : ["вольные"]
как : ["о","в","машины","и","бывает","на","старинные","же","его","за","их","хороший","о месте","в ресторан","машины их","и каждый","бывает среди","на кухне","на неизбежные","старинные бретеры","же Фома","за родную","их там","хороший знакомый"]
как бывает : ["среди"]
как в : ["ресторан"]
как же : ["Фома"]
как за : ["родную"]
как и : ["каждый"]
как их : ["там"]
как машины : ["их"]
как на : ["кухне","неизбежные"]
как о : ["месте"]
как старинные : ["бретеры"]
как хороший : ["знакомый"]
какие : ["тут","тут взятки"]
какие тут : ["взятки"]
какому : ["риску","риску я"]
какому риску : ["я"]
както : ["удалось","удалось замять"]
както удалось : ["замять"]
канаусовые : ["одеяла","одеяла и"]
канаусовые одеяла : ["и"]
кануна : ["благовещения","благовещения когда"]
кануна благовещения : ["когда"]
канцай : ["строго","строго обрывает"]
канцай строго : ["обрывает"]
кармане : ["новенькой","новенькой сторублевой"]
кармане новенькой : ["сторублевой"]
картинами : ["Маковского","Маковского «Боярский"]
картинами Маковского : ["«Боярский"]
карточек : []
каторжники : ["и","и офицеры"]
каторжники и : ["офицеры"]
квадратная : ["зала","зала с"]
квадратная зала : ["с"]
кивая : ["склоненной","склоненной набок"]
кивая склоненной : ["набок"]
кипела : ["до","до утра"]
кипела до : ["утра"]
кислой : ["сыростью","сыростью большой"]
кислой сыростью : ["большой"]
кислый : ["и","и чадный"]
кислый и : ["чадный"]
клавиши : []
клоаки : ["для","для избытка"]
клоаки для : ["избытка"]
ковер : ["с","с белой"]
ковер с : ["белой"]
коврами : ["диванами","диванами и"]
коврами диванами : ["и"]
когда : ["паровая","птица","Анна","паровая тяга","птица гнезда","Анна Марковна"]
когда Анна : ["Марковна"]
когда паровая : ["тяга"]
когда птица : ["гнезда"]
кого : ["в","в доме"]
кого в : ["доме"]
коекак : ["рваные","рваные темные"]
коекак рваные : ["темные"]
коечто : ["в","в своей"]
коечто в : ["своей"]
колебался : ["синий","синий табачный"]
колебался синий : ["табачный"]
комиков : []
комнате : ["хозяйки","хозяйки пьют"]
комнате хозяйки : ["пьют"]
комнаты : ["потом","потом нездорового"]
комнаты потом : ["нездорового"]
компанию : []
конный : ["извоз","извоз лихое"]
конный извоз : ["лихое"]
конца : ["день","день за"]
конца день : ["за"]
концу : ["XIX","XIX столетия"]
концу XIX : ["столетия"]
коньками : ["резными","резными наличниками"]
коньками резными : ["наличниками"]
копеек : ["и","и меньше"]
копеек и : ["меньше"]
коридор : ["вверху","вверху и"]
коридор вверху : ["и"]
коридорах : ["в","в кабинетах"]
коридорах в : ["кабинетах"]
кормит : ["жилами","жилами и"]
кормит жилами : ["и"]
коробочки : ["от","от папирос"]
коробочки от : ["папирос"]
короче : ["Ямой"]
косенькая : ["с","с розовым"]
косенькая с : ["розовым"]
костюмов : ["в","в пышности"]
костюмов в : ["пышности"]
костюмы : ["гусаров","по","гусаров пажей","по большей"]
костюмы гусаров : ["пажей"]
костюмы по : ["большей"]
косы : ["не","не заплетает"]
косы не : ["заплетает"]
котлеты : []
которая : ["слушала","слушала околоточного"]
которая слушала : ["околоточного"]
которой : ["был","был вчера"]
которой был : ["вчера"]
которую : ["посещают","она","посещают солдаты","она терзает"]
которую она : ["терзает"]
которую посещают : ["солдаты"]
который : ["ей","ей так"]
который ей : ["так"]
кофе : ["с","с жирными"]
кофе с : ["жирными"]
кофеем : ["и","и потом"]
кофеем и : ["потом"]
красавцы : ["и","и уроды"]
красавцы и : ["уроды"]
красивые : ["женщины"]
красивых : ["женщин","женщин в"]
красивых женщин : ["в"]
красной : ["коробочки","коробочки от"]
красной коробочки : ["от"]
красные : ["фонари"]
красными : ["кумачовыми","фонарями","кумачовыми кусками","фонарями над"]
красными кумачовыми : ["кусками"]
красными фонарями : ["над"]
красуются : ["снаружи","снаружи белые"]
красуются снаружи : ["белые"]
кратковременную : ["любовь","любовь а"]
кратковременную любовь : ["а"]
края» : []
крепкая : ["и","и свежая"]
крепкая и : ["свежая"]
крепкую : ["жидкость","жидкость проглатывает"]
крепкую жидкость : ["проглатывает"]
кривой : ["облупленный","облупленный и"]
кривой облупленный : ["и"]
кричит : ["на","на него"]
кричит на : ["него"]
кровавое : ["в","в своем"]
кровавое в : ["своем"]
кровати : ["еще","еще не"]
кровати еще : ["не"]
кроватях : ["сверх","сверх сбитых"]
кроватях сверх : ["сбитых"]
кругами : []
круглотолста : []
кружевами : []
крупные : ["белотелые","белотелые грудастые"]
крупные белотелые : ["грудастые"]
крутая : ["лестница","лестница и"]
крутая лестница : ["и"]
крылец : ["перил","перил и"]
крылец перил : ["и"]
куда : ["мы","мы идем"]
куда мы : ["идем"]
куданибудь : ["заблаговременно"]
кумачовыми : ["кусками"]
купили : ["на","на базаре"]
купили на : ["базаре"]
курят : ["пьют","пьют судорожно"]
курят пьют : ["судорожно"]
кусками : []
кухарке : ["вымыть","вымыть в"]
кухарке вымыть : ["в"]
кухне : ["рубят","пол","рубят к","пол и"]
кухне пол : ["и"]
кухне рубят : ["к"]
лавки : ["обслуживающие","обслуживающие надобности"]
лавки обслуживающие : ["надобности"]
лампады : ["перед","перед всеми"]
лампады перед : ["всеми"]
лампы : ["и","и зеленые"]
лампы и : ["зеленые"]
лапами : ["туго","туго натягивая"]
лапами туго : ["натягивая"]
лапах : ["деревянное","деревянное блюдо"]
лапах деревянное : ["блюдо"]
ласке : ["Амура","Амура и"]
ласке Амура : ["и"]
лба : ["вниз","вниз к"]
лба вниз : ["к"]
левой : ["руки","руки по"]
левой руки : ["по"]
ленивым : ["невыразительным","невыразительным блеклоголубым"]
ленивым невыразительным : ["блеклоголубым"]
ленивых : ["истеричных","истеричных бесплодных"]
ленивых истеричных : ["бесплодных"]
лестница : ["и","и узкий"]
лестница и : ["узкий"]
лестницам : []
лестнице : ["и","и хлопает"]
лестнице и : ["хлопает"]
лет : ["даже","под","сорока","даже до","под шестьдесят","сорока шести"]
лет даже : ["до"]
лет под : ["шестьдесят"]
лет сорока : ["шести"]
летнего : ["солнца"]
либеральные : ["адвокаты","адвокаты и"]
либеральные адвокаты : ["и"]
ликера : ["слегка","слегка разминает"]
ликера слегка : ["разминает"]
лихое : ["ямщичье","ямщичье племя"]
лихое ямщичье : ["племя"]
лица : ["спокойновластное","и","и прической"]
лица и : ["прической"]
лицами : ["хранящими","хранящими следы"]
лицами хранящими : ["следы"]
лицо : ["местный","местный околоточный"]
лицо местный : ["околоточный"]
лишком : ["заведениях","заведениях разница"]
лишком заведениях : ["разница"]
ложнорусском : ["ёрническом","ёрническом ропетовском"]
ложнорусском ёрническом : ["ропетовском"]
лучше : ["пошли","сплавьте","пошли распорядились","сплавьте куданибудь"]
лучше пошли : ["распорядились"]
лучше сплавьте : ["куданибудь"]
лучшего : ["Анна","Анна Марковна"]
лучшего Анна : ["Марковна"]
лысоват : ["у","у него"]
лысоват у : ["него"]
льстиво : ["и","и фамильярно"]
льстиво и : ["фамильярно"]
любви : []
любовниках : []
любовь : ["а","а следовательно"]
любовь а : ["следовательно"]
любовью : ["постепенно","и","постепенно стали","и фантастической"]
любовью и : ["фантастической"]
любовью постепенно : ["стали"]
любую : ["женщину","женщину и"]
любую женщину : ["и"]
люди : ["глядят","глядят на"]
люди глядят : ["на"]
людьми : ["и","и экипажами"]
людьми и : ["экипажами"]
люстрой : ["посредине","посредине тоже"]
люстрой посредине : ["тоже"]
мадам : ["Шойбес","Шойбес говорит","Шойбес это"]
мадам Шойбес : ["говорит","это"]
мала : ["ростом","ростом но"]
мала ростом : ["но"]
маленькие : ["черные","неприятности","неприятности профессий"]
маленькие неприятности : ["профессий"]
маленький : ["втиснутых","седенький","втиснутых друг","седенький тихонький"]
маленький втиснутых : ["друг"]
маленький седенький : ["тихонький"]
малиновой : ["губой"]
малиновую : ["губу","губу и"]
малиновую губу : ["и"]
малиновые : ["шелковые","шелковые тяжелые"]
малиновые шелковые : ["тяжелые"]
мальчики : ["кадеты","кадеты и"]
мальчики кадеты : ["и"]
манежах : ["и","и помещениях"]
манежах и : ["помещениях"]
марочки : []
марш : ["для","для загулявших"]
марш для : ["загулявших"]
маскарадные : ["костюмы","костюмы гусаров"]
маскарадные костюмы : ["гусаров"]
маслянистую : ["острую","острую крепкую"]
маслянистую острую : ["крепкую"]
мастики : ["которой","которой был"]
мастики которой : ["был"]
матросские : ["костюмы","костюмы по"]
матросские костюмы : ["по"]
машины : ["их","их желаниям"]
машины их : ["желаниям"]
медведя : ["держащее","держащее в"]
медведя держащее : ["в"]
медленно : ["втягивает","втягивает в"]
медленно втягивает : ["в"]
мелкие : ["воришки","воришки ремесленники"]
мелкие воришки : ["ремесленники"]
мелочах : []
мелочные : ["лавки","лавки обслуживающие"]
мелочные лавки : ["обслуживающие"]
менее : ["красивых","красивых женщин"]
менее красивых : ["женщин"]
меньше : ["совсем","совсем уж"]
меньше совсем : ["уж"]
меня : ["сын","ученики","тоже","сын гимназист","ученики ругают"]
меня сын : ["гимназист"]
меня ученики : ["ругают"]
меняя : ["спокойного","спокойного выражения"]
меняя спокойного : ["выражения"]
места : ["в","в другое"]
места в : ["другое"]
месте : ["развеселом","развеселом пьяном"]
месте развеселом : ["пьяном"]
местность : ["называлась","называлась Ямской"]
местность называлась : ["Ямской"]
местный : ["околоточный","околоточный надзиратель"]
местный околоточный : ["надзиратель"]
месяцы : ["и","и годы"]
месяцы и : ["годы"]
мехом : ["или","или в"]
мехом или : ["в"]
мигая : ["околоточному","околоточному ленивым"]
мигая околоточному : ["ленивым"]
минут : ["оба","оба возвращаются"]
минут оба : ["возвращаются"]
минутной : ["власти","власти над"]
минутной власти : ["над"]
минуту : ["и","и говорит"]
минуту и : ["говорит"]
мировых : ["таинств","таинств таинство"]
мировых таинств : ["таинство"]
младшая : []
мне : ["марочки"]
много : ["лет","лет даже"]
много лет : ["даже"]
многогранного : ["рефлектора","рефлектора лампы"]
многогранного рефлектора : ["лампы"]
многозначительно : []
мной : ["разговаривать","разговаривать не"]
мной разговаривать : ["не"]
могу : ["поделать"]
мое : ["положение"]
моем : ["околотке"]
можно : ["себе","себе представить"]
можно себе : ["представить"]
мой : ["куда","совет","куда мы","совет вам"]
мой куда : ["мы"]
мой совет : ["вам"]
мокрой : ["нижней","нижней малиновой"]
мокрой нижней : ["малиновой"]
молодецкие : ["обычаи","обычаи перешло"]
молодецкие обычаи : ["перешло"]
молодожены : ["и","и влюбленные"]
молодожены и : ["влюбленные"]
молчаливый : ["старичок"]
молчание : []
мордой : ["то","то скачет"]
мордой то : ["скачет"]
морщит : ["нос","нос улыбается"]
морщит нос : ["улыбается"]
морщится : ["околоточный"]
муж : ["Исай","Исай Саввич"]
муж Исай : ["Саввич"]
мужчин : ["подымаются","и","подымаются и","и женщин"]
мужчин и : ["женщин"]
мужчин подымаются : ["и"]
мужчину : ["нередко","нередко уже"]
мужчину нередко : ["уже"]
мужчины : ["и","и троице"]
мужчины и : ["троице"]
музыка : ["скрипок","колебался","скрипок и","колебался синий"]
музыка колебался : ["синий"]
музыка скрипок : ["и"]
мы : ["нарочно","идем","только","нарочно держим","только идем"]
мы нарочно : ["держим"]
мы только : ["идем"]
мылом : ["и","и пылью"]
мылом и : ["пылью"]
мягкими : ["атласными","атласными пуфами"]
мягкими атласными : ["пуфами"]
мягких : ["студенистых","студенистых шара"]
мягких студенистых : ["шара"]
мяса : ["цепную","цепную собаку"]
мяса цепную : ["собаку"]
мясом : ["кричит","кричит на"]
мясом кричит : ["на"]
на : ["самой","много","развалинах","Большую","лестнице","окнах","Малой","кроватях","дворе","вокзал","публичной","базаре","кухне","широкой","ночь","девушку","него","чье","скрипке","покой","совести","богатой","неизбежные","темное","стол","наши","друга","нынешнее","Ямской","всех","вас","самих","жаргоне","одного","службу","дорожку","минуту","самой дальней","много лет","развалинах тех","Большую Ямскую","окнах малиновые","Малой Ямской","кроватях сверх","дворе стемнеет","вокзал сидят","публичной кровати","базаре целый","кухне рубят","широкой постели","ночь с","девушку передними","него с","чье имя","скрипке и","покой продаст","совести несколько","богатой семидесятилетней","неизбежные маленькие","темное и","стол разводя","наши переделки","нынешнее падение","Ямской и","всех донесет","вас на","самих себя","жаргоне публичных","одного человека","минуту и","лестнице и"]
на Большую : ["Ямскую"]
на Малой : ["Ямской"]
на Ямской : ["и"]
на базаре : ["целый"]
на богатой : ["семидесятилетней"]
на вас : ["на"]
на вокзал : ["сидят"]
на всех : ["донесет"]
на дворе : ["стемнеет"]
на девушку : ["передними"]
на жаргоне : ["публичных"]
на кроватях : ["сверх"]
на кухне : ["рубят"]
на лестнице : ["и"]
на минуту : ["и"]
на много : ["лет"]
на наши : ["переделки"]
на него : ["с"]
на неизбежные : ["маленькие"]
на ночь : ["с"]
на нынешнее : ["падение"]
на одного : ["человека"]
на окнах : ["малиновые"]
на покой : ["продаст"]
на публичной : ["кровати"]
на развалинах : ["тех"]
на самих : ["себя"]
на самой : ["дальней"]
на скрипке : ["и"]
на совести : ["несколько"]
на стол : ["разводя"]
на темное : ["и"]
на чье : ["имя"]
на широкой : ["постели"]
набожно : ["кивая","кивая склоненной"]
набожно кивая : ["склоненной"]
набок : ["головой"]
наглые : ["больные","больные и"]
наглые больные : ["и"]
над : ["шатровыми","подъездами","собакой","столом","шатровыми резными","подъездами и","собакой и","столом подслеповатый"]
над подъездами : ["и"]
над собакой : ["и"]
над столом : ["подслеповатый"]
над шатровыми : ["резными"]
надзиратель : ["Кербеш"]
надзором : ["и","и подчиненные"]
надзором и : ["подчиненные"]
надо : []
надобности : ["ямской","ямской проституции"]
надобности ямской : ["проституции"]
наемные : ["патриоты"]
назад : ["он","он женился"]
назад он : ["женился"]
называлась : ["Ямской","Ямской слободой"]
называлась Ямской : ["слободой"]
называют : ["ее","ее безлично"]
называют ее : ["безлично"]
наивно : ["раскрашенными","раскрашенными при"]
наивно раскрашенными : ["при"]
накрепко : ["закрытыми","закрытыми дверями"]
накрепко закрытыми : ["дверями"]
налево : []
наличниками : ["петухами","петухами и"]
наличниками петухами : ["и"]
наличными : ["а","а часть"]
наличными а : ["часть"]
наперед : ["что","что никогда"]
наперед что : ["никогда"]
наравне : ["с","с хозяйкой"]
наравне с : ["хозяйкой"]
народ : ["серый","серый и"]
народ серый : ["и"]
нарочитым : ["суровым","суровым правилам"]
нарочитым суровым : ["правилам"]
нарочно : ["держим","держим ее"]
нарочно держим : ["ее"]
нарядности : ["костюмов","костюмов в"]
нарядности костюмов : ["в"]
нас : ["был","был третьего"]
нас был : ["третьего"]
насиженных : ["гнезд","гнезд где"]
насиженных гнезд : ["где"]
настежь : ["и","и сквозь"]
настежь и : ["сквозь"]
натерт : ["паркет"]
натягивая : ["цепь","цепь и"]
натягивая цепь : ["и"]
нахальство : []
находится : ["у","у вас"]
находится у : ["вас"]
начальнику : ["края»"]
начальством : ["руководимые","руководимые официальным"]
начальством руководимые : ["официальным"]
наши : ["переделки"]
нашу : ["Берточку","Берточку она"]
нашу Берточку : ["она"]
не : ["больше","достающими","заплетает","вьет","встретят","остывшей","смеют","остался","тайна","меняя","чувствовали","пьет","стоит","торопясь","об","оберешься","глядя","возобновляется","нахальство","было","сын","хочет","рассказывайте","думают","больше пятишести","достающими до","заплетает едва","вьет и","встретят отказа","остывшей от","смеют этого","остался и","тайна что","меняя спокойного","чувствовали никаких","пьет а","торопясь кофеем","об этом","глядя друг","было иначе","сын ищи","рассказывайте вздыхает"]
не больше : ["пятишести"]
не было : ["иначе"]
не встретят : ["отказа"]
не вьет : ["и"]
не глядя : ["друг"]
не достающими : ["до"]
не заплетает : ["едва"]
не меняя : ["спокойного"]
не об : ["этом"]
не остался : ["и"]
не остывшей : ["от"]
не пьет : ["а"]
не рассказывайте : ["вздыхает"]
не смеют : ["этого"]
не сын : ["ищи"]
не тайна : ["что"]
не торопясь : ["кофеем"]
не чувствовали : ["никаких"]
небезопасном : []
невыразительным : ["блеклоголубым","блеклоголубым глазом"]
невыразительным блеклоголубым : ["глазом"]
него : ["с","рыжая","на","с притворной","рыжая борода","на совести"]
него на : ["совести"]
него рыжая : ["борода"]
него с : ["притворной"]
негодяй : ["и","и заяви"]
негодяй и : ["заяви"]
недели : ["и","и кануна"]
недели и : ["кануна"]
нее : ["вчера","блеклоголубые","окружены","всегда","вчера вечером","блеклоголубые девичьи","окружены черными","всегда есть"]
нее блеклоголубые : ["девичьи"]
нее всегда : ["есть"]
нее вчера : ["вечером"]
нее окружены : ["черными"]
нежилой : ["комнаты","комнаты потом"]
нежилой комнаты : ["потом"]
нездорового : ["и","и нечистого"]
нездорового и : ["нечистого"]
неизбежные : ["маленькие","маленькие неприятности"]
неизбежные маленькие : ["неприятности"]
ней : ["темно","никто","темно прохладно","никто не"]
ней никто : ["не"]
ней темно : ["прохладно"]
некоторых : ["внешних","внешних мелочах"]
некоторых внешних : ["мелочах"]
некрасивая : ["в","в веснушках"]
некрасивая в : ["веснушках"]
неловко : []
нельзя : ["положиться","положиться продолжает"]
нельзя положиться : ["продолжает"]
нелюдимо : ["как","как бывает"]
нелюдимо как : ["бывает"]
немки : ["крупные","крупные белотелые"]
немки крупные : ["белотелые"]
немножко : ["расширить","расширить помещение"]
немножко расширить : ["помещение"]
неподвижный : ["воздух","воздух еще"]
неподвижный воздух : ["еще"]
неправдоподобной : ["жизнью","жизнью выброшенные"]
неправдоподобной жизнью : ["выброшенные"]
непривычно : ["задумчивой","задумчивой строгой"]
непривычно задумчивой : ["строгой"]
неприятностей : ["не","не оберешься"]
неприятностей не : ["оберешься"]
неприятности : ["профессий"]
нередко : ["уже","уже ждущего"]
нередко уже : ["ждущего"]
несколько : ["поплоше","темных","поплоше победнее","темных дел"]
несколько поплоше : ["победнее"]
несколько темных : ["дел"]
нет : ["уважения","уважения к"]
нет уважения : ["к"]
нечистого : ["женского","женского тела"]
нечистого женского : ["тела"]
ни : ["на","прислуга","на одного","прислуга то"]
ни на : ["одного"]
ни прислуга : ["то"]
нижней : ["малиновой","малиновой губой"]
нижней малиновой : ["губой"]
нижнюю : ["малиновую","малиновую губу"]
нижнюю малиновую : ["губу"]
никаких : ["угрызений","угрызений совести"]
никаких угрызений : ["совести"]
никогда : ["не","не встретят"]
никогда не : ["встретят"]
никто : ["не","не остался"]
никто не : ["остался"]
ним : ["парадная","парадная дверь"]
ним парадная : ["дверь"]
них : ["помещаются","остзейские","видны","в","помещаются трактиры","остзейские немки","видны с","в ту"]
них в : ["ту"]
них видны : ["с"]
них остзейские : ["немки"]
них помещаются : ["трактиры"]
но : ["и","крепкая","на","круглотолста","рот","ведь","как","и в","крепкая и","на ночь","рот старческий","ведь она","как хороший"]
но ведь : ["она"]
но и : ["в"]
но как : ["хороший"]
но крепкая : ["и"]
но на : ["ночь"]
но рот : ["старческий"]
новенькой : ["сторублевой"]
новой : ["жизни"]
ногами : ["вверх","толстую","вверх пары","толстую траву"]
ногами вверх : ["пары"]
ногами толстую : ["траву"]
нос : ["улыбается","строго","улыбается скулит","строго подобранные"]
нос строго : ["подобранные"]
нос улыбается : ["скулит"]
носами : ["с","с лицами"]
носами с : ["лицами"]
носились : ["вихряя","вихряя бедрами"]
носились вихряя : ["бедрами"]
носит : ["совсем","совсем другую"]
носит совсем : ["другую"]
носом : ["и","и говорит"]
носом и : ["говорит"]
ночи : []
ночную : ["пору","пору небезопасном"]
ночную пору : ["небезопасном"]
ночные : ["гости","гости уже"]
ночные гости : ["уже"]
ночь : ["десять","с","руками","без","с теми","с ней","без мужчины"]
ночь без : ["мужчины"]
ночь с : ["теми","ней"]
нравов : []
нравственности : ["педагоги","педагоги и"]
нравственности педагоги : ["и"]
нравственность : ["падает","падает нет"]
нравственность падает : ["нет"]
нравы : ["и","и обычаи"]
нравы и : ["обычаи"]
ну : ["словом","словом в"]
ну словом : ["в"]
нынешнее : ["падение","падение нравов"]
нынешнее падение : ["нравов"]
нёбу : ["маслянистую","маслянистую острую"]
нёбу маслянистую : ["острую"]
о : ["месте","женском","своих","совращенной","месте развеселом","женском равноправии","своих жертвах","совращенной девушке","своих любовниках","своих обязанностях"]
о женском : ["равноправии"]
о месте : ["развеселом"]
о своих : ["жертвах","любовниках","обязанностях"]
о совращенной : ["девушке"]
об : ["этом","этом говорю"]
об этом : ["говорю"]
оба : ["возвращаются","возвращаются не"]
оба возвращаются : ["не"]
обе : ["улицы","улицы Ямы"]
обе улицы : ["Ямы"]
обеду : ["котлеты"]
обезьяны : []
оберегательницы : ["семейной","семейной чести"]
оберегательницы семейной : ["чести"]
оберешься : []
обитательницы : ["одеты","одеты в"]
обитательницы одеты : ["в"]
облупленный : ["и","и занозистый"]
облупленный и : ["занозистый"]
обманным : ["образом","образом вовлечена"]
обманным образом : ["вовлечена"]
обманщица : []
обожает : ["актеров","актеров преимущественно"]
обожает актеров : ["преимущественно"]
образами : []
образом : ["вовлечена","вовлечена в"]
образом вовлечена : ["в"]
обрезками : ["мяса","мяса цепную"]
обрезками мяса : ["цепную"]
обрывает : ["ее","ее на"]
обрывает ее : ["на"]
обслуживающие : ["надобности","надобности ямской"]
обслуживающие надобности : ["ямской"]
обставлены : []
обстановки : []
обстановкой : ["причем","причем часть"]
обстановкой причем : ["часть"]
общем : ["зале"]
общества : ["в","в золотых"]
общества в : ["золотых"]
общественного : ["темперамента","темперамента клоаки"]
общественного темперамента : ["клоаки"]
обществом : ["проклятые","проклятые семьей"]
обществом проклятые : ["семьей"]
обычаи : ["перешло","почти","перешло к","почти одинаковы"]
обычаи перешло : ["к"]
обычаи почти : ["одинаковы"]
обычаю : ["горничные","горничные заведения"]
обычаю горничные : ["заведения"]
обязанностях : ["и","и не"]
обязанностях и : ["не"]
огни : ["звенела","звенела разудалая"]
огни звенела : ["разудалая"]
одеты : ["в","в открытые"]
одеты в : ["открытые"]
одетые : ["в","в цветное"]
одетые в : ["цветное"]
одеяла : ["и","и чистые"]
одеяла и : ["чистые"]
один : ["гость","гость толстый"]
один гость : ["толстый"]
одинаковы : ["во","во всех"]
одинаковы во : ["всех"]
одна : ["на","совсем","на широкой","совсем одна"]
одна на : ["широкой"]
одна совсем : ["одна"]
однако : ["ему","ему както"]
однако ему : ["както"]
одного : ["места","человека","места в","человека нельзя"]
одного места : ["в"]
одного человека : ["нельзя"]
однообразными : ["словами","словами с"]
однообразными словами : ["с"]
одолжение : []
оказались : ["занятыми","занятыми сплошь"]
оказались занятыми : ["сплошь"]
окаймленными : ["деревянными","деревянными же"]
окаймленными деревянными : ["же"]
окна : ["завешены","ярко","завешены красными","ярко освещены"]
окна завешены : ["красными"]
окна ярко : ["освещены"]
окнах : ["малиновые","малиновые шелковые"]
окнах малиновые : ["шелковые"]
около : ["крылец","крылец перил"]
около крылец : ["перил"]
околотке : []
околоточного : ["набожно","набожно кивая"]
околоточного набожно : ["кивая"]
околоточному : ["ленивым","ленивым невыразительным"]
околоточному ленивым : ["невыразительным"]
околоточный : ["надзиратель","с","надзиратель Кербеш","с бенедиктином"]
околоточный надзиратель : ["Кербеш"]
околоточный с : ["бенедиктином"]
окон : ["и","и кипела"]
окон и : ["кипела"]
окраине : ["большого","большого южного"]
окраине большого : ["южного"]
окружены : ["черными","черными геморроидальными"]
окружены черными : ["геморроидальными"]
олеографическими : ["картинами","картинами Маковского"]
олеографическими картинами : ["Маковского"]
он : ["лысоват","раньше","женился","собственно","глядя","останавливается","лысоват у","раньше служил","женился на","собственно не","глядя на","останавливается на"]
он глядя : ["на"]
он женился : ["на"]
он лысоват : ["у"]
он останавливается : ["на"]
он раньше : ["служил"]
он собственно : ["не"]
она : ["прекрасно","кормит","дразня","от","собственноручно","терзает","относится","же","здесь","в","из","прекрасно сладко","кормит жилами","дразня его","от души","собственноручно бьет","терзает своей","относится с","же совершеннолетняя","здесь как","в гимназии","из гимназии"]
она в : ["гимназии"]
она дразня : ["его"]
она же : ["совершеннолетняя"]
она здесь : ["как"]
она из : ["гимназии"]
она кормит : ["жилами"]
она от : ["души"]
она относится : ["с"]
она прекрасно : ["сладко"]
она собственноручно : ["бьет"]
она терзает : ["своей"]
они : ["еще","в","еще хуже","в своих"]
они в : ["своих"]
они еще : ["хуже"]
оправляет : ["шашку"]
опушенные : ["мехом","мехом или"]
опушенные мехом : ["или"]
освещены : ["веселая","веселая музыка"]
освещены веселая : ["музыка"]
оскверненными : ["за","за ночь"]
оскверненными за : ["ночь"]
особенно : ["нелюдимо","нелюдимо как"]
особенно нелюдимо : ["как"]
осоки : ["и","и разбросали"]
осоки и : ["разбросали"]
осокой : []
осталась : ["темная","темная слава"]
осталась темная : ["слава"]
осталось : ["не","не больше"]
осталось не : ["больше"]
остался : ["и","и оттого"]
остался и : ["оттого"]
остальные : ["четверо","четверо тоже"]
остальные четверо : ["тоже"]
останавливается : ["на","на минуту"]
останавливается на : ["минуту"]
остзейские : ["немки","немки крупные"]
остзейские немки : ["крупные"]
острую : ["крепкую","крепкую жидкость"]
острую крепкую : ["жидкость"]
остывшей : ["от","от тела"]
остывшей от : ["тела"]
от : ["времени","папирос","тела","желтой","возбуждения","удушья","души","лба","времени пятнистые","тела предшественника","желтой мастики","удушья то","души рада","лба вниз"]
от времени : ["пятнистые"]
от души : ["рада"]
от желтой : ["мастики"]
от лба : ["вниз"]
от тела : ["предшественника"]
от удушья : ["то"]
отвесив : ["свою","свою нижнюю"]
отвесив свою : ["нижнюю"]
отвислыми : ["телами","телами с"]
отвислыми телами : ["с"]
отвисшей : ["бессильно","бессильно мокрой"]
отвисшей бессильно : ["мокрой"]
отказа : []
открыты : ["настежь","настежь и"]
открыты настежь : ["и"]
открытые : ["публичные","бальные","публичные дома","бальные платья"]
открытые бальные : ["платья"]
открытые публичные : ["дома"]
относится : ["с","с подобострастием"]
относится с : ["подобострастием"]
оттого : ["в","она","в ней","она прекрасно"]
оттого в : ["ней"]
оттого она : ["прекрасно"]
отцы : ["семейств","семейств почтенные"]
отцы семейств : ["почтенные"]
офицеры : ["и","и студенты"]
офицеры и : ["студенты"]
официальным : ["надзором","надзором и"]
официальным надзором : ["и"]
очарованием : ["примешивается","примешивается к"]
очарованием примешивается : ["к"]
очень : ["мала","мала ростом"]
очень мала : ["ростом"]
очереди : ["в","в общем"]
очереди в : ["общем"]
очках : ["и","и молодожены"]
очках и : ["молодожены"]
падает : ["нет","нет уважения"]
падает нет : ["уважения"]
падение : ["нравов"]
пажей : ["рыбачек","рыбачек гимназисток"]
пажей рыбачек : ["гимназисток"]
пальцем : ["левой","левой руки"]
пальцем левой : ["руки"]
папа : ["на","на вас"]
папа на : ["вас"]
папирос : []
парадная : ["дверь","дверь Эмма"]
парадная дверь : ["Эмма"]
паразитами : ["брюхатые","брюхатые геморроидальные"]
паразитами брюхатые : ["геморроидальные"]
паркет : ["на","на окнах"]
паркет на : ["окнах"]
паров : ["и","и запаха"]
паров и : ["запаха"]
паровая : ["тяга","тяга убила"]
паровая тяга : ["убила"]
пары : ["мужчин","мужчин и"]
пары мужчин : ["и"]
пасха : []
патриоты : []
пахнет : ["духами","полуувядшей","духами табаком","полуувядшей осокой"]
пахнет духами : ["табаком"]
пахнет полуувядшей : ["осокой"]
педагоги : ["и","и передовые"]
педагоги и : ["передовые"]
пейзажами : []
пеняют : ["на","на самих"]
пеняют на : ["самих"]
первое : ["число"]
первый : ["дом","дом налево"]
первый дом : ["налево"]
перегородками : ["не","не достающими"]
перегородками не : ["достающими"]
перед : ["каждым","вечером","всеми","каждым домом","вечером женщины","всеми образами"]
перед вечером : ["женщины"]
перед всеми : ["образами"]
перед каждым : ["домом"]
переделки : []
передней : ["чучело","чучело медведя"]
передней чучело : ["медведя"]
передними : ["лапами","лапами туго"]
передними лапами : ["туго"]
передовые : ["писатели","писатели авторы"]
передовые писатели : ["авторы"]
перешло : ["к","к другим"]
перешло к : ["другим"]
перил : ["и","и дверей"]
перил и : ["дверей"]
пес : ["с","с длинной"]
пес с : ["длинной"]
пестрой : ["жизни"]
петухами : ["и","и деревянными"]
петухами и : ["деревянными"]
пир» : ["и","и «Купанье»"]
пир» и : ["«Купанье»"]
писатели : ["авторы","авторы горячих"]
писатели авторы : ["горячих"]
плате : ["взимаемой","взимаемой за"]
плате взимаемой : ["за"]
платья : ["опушенные","опушенные мехом"]
платья опушенные : ["мехом"]
платят : ["вперед","вперед деньги"]
платят вперед : ["деньги"]
племя : ["понемногу","понемногу растеряло"]
племя понемногу : ["растеряло"]
плешивые : ["трясущиеся","трясущиеся покрытые"]
плешивые трясущиеся : ["покрытые"]
плюшевых : ["стульев","стульев чинно"]
плюшевых стульев : ["чинно"]
по : ["другую","ту","Большой","большей","этим","традиции","смутным","вечерам","векселю","сыскной","усам","нёбу","доброй","первое","другую сторону","ту и","Большой Ямской","большей части","этим лестницам","традиции не","смутным воспоминаниям","вечерам играет","сыскной части","усам вправо","нёбу маслянистую","доброй воле","первое число","ту сторону"]
по Большой : ["Ямской"]
по большей : ["части"]
по вечерам : ["играет"]
по доброй : ["воле"]
по другую : ["сторону"]
по нёбу : ["маслянистую"]
по первое : ["число"]
по смутным : ["воспоминаниям"]
по сыскной : ["части"]
по традиции : ["не"]
по ту : ["и","сторону"]
по усам : ["вправо"]
по этим : ["лестницам"]
побаиваются : []
победнее : []
поблескивает : ["фортепиано","фортепиано своим"]
поблескивает фортепиано : ["своим"]
побоев : ["и","и царапин"]
побоев и : ["царапин"]
побои : []
повсюду : []
поглядеть : ["на","на наши"]
поглядеть на : ["наши"]
погруженной : ["в","в сон"]
погруженной в : ["сон"]
погружено : ["в","в сон"]
погружено в : ["сон"]
под : ["ногами","шестьдесят","башмаком","ногами толстую"]
под ногами : ["толстую"]
подборе : ["более","более или"]
подборе более : ["или"]
подбородков : []
подвергаюсь : []
поделать : []
подлец : ["и","и заявляет"]
подлец и : ["заявляет"]
подобно : ["тому","тому как"]
подобно тому : ["как"]
подобострастием : []
подобранные : ["губы"]
подслеповатый : ["Исай","Исай Саввич"]
подслеповатый Исай : ["Саввич"]
подтверждает : ["Исай","Исай Саввич"]
подтверждает Исай : ["Саввич"]
подумайте : ["какому","какому риску"]
подумайте какому : ["риску"]
подушки : []
подчиненные : ["нарочитым","нарочитым суровым"]
подчиненные нарочитым : ["суровым"]
подъезд : ["двумя","двумя срубленными"]
подъезд двумя : ["срубленными"]
подъездами : ["висячие","и","висячие красные","и светом"]
подъездами висячие : ["красные"]
подъездами и : ["светом"]
подъезжают : ["и","и уезжают"]
подъезжают и : ["уезжают"]
подымаются : ["и","и спускаются"]
подымаются и : ["спускаются"]
пожалуйте : ["мне","мне марочки"]
пожалуйте мне : ["марочки"]
познающие : ["впервые","впервые женщину"]
познающие впервые : ["женщину"]
пока : ["их","их барышни"]
пока их : ["барышни"]
покажу : []
покамест : ["еще","еще называют"]
покамест еще : ["называют"]
покой : ["продаст","продаст ей"]
покой продаст : ["ей"]
покраснела : ["подтверждает","подтверждает Исай"]
покраснела подтверждает : ["Исай"]
покрытые : ["паразитами","паразитами брюхатые"]
покрытые паразитами : ["брюхатые"]
пол : ["в","и","в зале","и столы"]
пол в : ["зале"]
пол и : ["столы"]
полезным : ["выучился","выучился играть"]
полезным выучился : ["играть"]
полицейский : ["и","и что"]
полицейский и : ["что"]
полицию : []
полная : ["шатенка","шатенка лет"]
полная шатенка : ["лет"]
половой : ["любви"]
положение : []
положиться : ["продолжает","продолжает ворчливо"]
положиться продолжает : ["ворчливо"]
полотенцами : ["окаймленными","окаймленными деревянными"]
полотенцами окаймленными : ["деревянными"]
полрюмки : ["ликера","ликера слегка"]
полрюмки ликера : ["слегка"]
полумраке : ["кажется","кажется непривычно"]
полумраке кажется : ["непривычно"]
полупровалившимися : ["носами","носами с"]
полупровалившимися носами : ["с"]
полуразрушенные : ["слюнявые","слюнявые старцы"]
полуразрушенные слюнявые : ["старцы"]
полуувядшей : ["осокой"]
получит : ["наличными","наличными а"]
получит наличными : ["а"]
помещаются : ["трактиры","трактиры портерные"]
помещаются трактиры : ["портерные"]
помещение : []
помещения : ["и","и роскоши"]
помещения и : ["роскоши"]
помещениях : ["суда"]
помогла : ["кухарке","кухарке вымыть"]
помогла кухарке : ["вымыть"]
помощи : ["послюненной","послюненной красной"]
помощи послюненной : ["красной"]
понемногу : ["растеряло","затихает","растеряло свои","затихает и"]
понемногу затихает : ["и"]
понемногу растеряло : ["свои"]
понимаете : ["всетаки","всетаки неловко"]
понимаете всетаки : ["неловко"]
понимаю : []
попадает : ["из","из одного"]
попадает из : ["одного"]
поплоше : ["победнее"]
попрошу : ["вас","вас поглядеть"]
попрошу вас : ["поглядеть"]
пора : ["и","и на"]
пора и : ["на"]
порока : []
портерные : ["и","и мелочные"]
портерные и : ["мелочные"]
пору : ["небезопасном","когда","когда Анна"]
пору когда : ["Анна"]
посещают : ["солдаты","солдаты мелкие"]
посещают солдаты : ["мелкие"]
после : ["них","них в"]
после них : ["в"]
последних : ["дней","дней страстной"]
последних дней : ["страстной"]
послюненной : ["красной","красной коробочки"]
послюненной красной : ["коробочки"]
поспешно : ["допивая","допивая бенедиктин"]
поспешно допивая : ["бенедиктин"]
поспешностью : ["выбирают","выбирают любую"]
поспешностью выбирают : ["любую"]
посредине : ["тоже","тоже спит"]
посредине тоже : ["спит"]
постели : []
постепенно : ["стали","стали вырастать"]
постепенно стали : ["вырастать"]
потолка : ["а","а на"]
потолка а : ["на"]
потом : ["нездорового","проводит","нездорового и","проводит безымянным"]
потом нездорового : ["и"]
потом проводит : ["безымянным"]
почтенном : ["семействе"]
почтенные : ["профессоры","столпы","профессоры с","столпы общества"]
почтенные профессоры : ["с"]
почтенные столпы : ["общества"]
почти : ["одинаковы","дети","одинаковы во"]
почти одинаковы : ["во"]
пошли : ["распорядились","распорядились завтраком"]
пошли распорядились : ["завтраком"]
правами : ["и","и обстановкой"]
правами и : ["обстановкой"]
правилам : []
праздник : ["пасха"]
представить : ["вообразив","вообразив снизу"]
представить вообразив : ["снизу"]
предупреждаюс : []
предшественника : ["совершают","совершают бесцельно"]
предшественника совершают : ["бесцельно"]
презрительно : []
преимущественно : ["толстых","толстых комиков"]
преимущественно толстых : ["комиков"]
прекрасно : ["сладко","сладко выспалась"]
прекрасно сладко : ["выспалась"]
прекрасное : ["из","из мировых"]
прекрасное из : ["мировых"]
при : ["въезде","помощи","допросах","воспоминании","въезде на","помощи послюненной","воспоминании о"]
при воспоминании : ["о"]
при въезде : ["на"]
при помощи : ["послюненной"]
пригибает : ["голову","голову к"]
пригибает голову : ["к"]
приказчиков : ["жаждущих","жаждущих пьяных"]
приказчиков жаждущих : ["пьяных"]
примесью : ["алкогольных","алкогольных паров"]
примесью алкогольных : ["паров"]
примешивается : ["к","к этим"]
примешивается к : ["этим"]
приносит : ["такие","такие слова"]
приносит такие : ["слова"]
принять : ["третьего","третьего четвертого"]
принять третьего : ["четвертого"]
природой : ["глухонемые","глухонемые слепые"]
природой глухонемые : ["слепые"]
прислуга : ["то","то стерва"]
прислуга то : ["стерва"]
притворной : ["строгостью"]
притворяются : ["веселыми","веселыми танцуют"]
притворяются веселыми : ["танцуют"]
приходится : ["видеть"]
причем : ["часть","часть получит"]
причем часть : ["получит"]
прической : ["барашком"]
приятный : ["голос"]
провела : ["ночь","ночь без"]
провела ночь : ["без"]
проводит : ["безымянным","безымянным пальцем"]
проводит безымянным : ["пальцем"]
проглатывает : ["ее","ее запивает"]
проглатывает ее : ["запивает"]
продаст : ["ей","ей заведение"]
продаст ей : ["заведение"]
продолжает : ["ворчливо","ворчливо хозяйка"]
продолжает ворчливо : ["хозяйка"]
произносит : ["басом","басом с"]
произносит басом : ["с"]
проклятые : ["семьей","семьей жертвы"]
проклятые семьей : ["жертвы"]
промежутков : []
проснутся : ["и","и будут"]
проснутся и : ["будут"]
проституции : []
просто : ["Ямской","как","Ямской Ямками","как в"]
просто Ямской : ["Ямками"]
просто как : ["в"]
просторной : ["погруженной","погруженной в"]
просторной погруженной : ["в"]
простыни : ["и","и дырявые"]
простыни и : ["дырявые"]
протянутых : ["лапах","лапах деревянное"]
протянутых лапах : ["деревянное"]
профессий : []
профессиональными : ["движениями","движениями удовлетворяют"]
профессиональными движениями : ["удовлетворяют"]
профессоры : ["с","с громкими"]
профессоры с : ["громкими"]
прохладно : ["и","и так"]
прохладно и : ["так"]
проходит : ["вся","вся ночь"]
проходит вся : ["ночь"]
прошлом : ["году","как","году задушил","как на"]
прошлом году : ["задушил"]
прошлом как : ["на"]
прямо : ["аж","аж вся"]
прямо аж : ["вся"]
птица : ["гнезда","гнезда не"]
птица гнезда : ["не"]
публичной : ["кровати","кровати еще"]
публичной кровати : ["еще"]
публичные : ["дома","дома разрешенные"]
публичные дома : ["разрешенные"]
публичных : ["гаремах","домов»","домов","гаремах странной","домов Эмма"]
публичных гаремах : ["странной"]
публичных домов : ["Эмма"]
пудрой : ["борнотимоловым","борнотимоловым мылом"]
пудрой борнотимоловым : ["мылом"]
пуста : []
пусто : ["и","и сонно"]
пусто и : ["сонно"]
пустых : ["театрах","театрах манежах"]
пустых театрах : ["манежах"]
пусть : ["пеняют","пеняют на"]
пусть пеняют : ["на"]
пуфами : []
пылью : ["от","от желтой"]
пылью от : ["желтой"]
пышности : ["помещения","помещения и"]
пышности помещения : ["и"]
пьет : ["а","а только"]
пьет а : ["только"]
пьют : ["судорожно","кофе","судорожно притворяются"]
пьют судорожно : ["притворяются"]
пьяном : ["драчливом","драчливом и"]
пьяном драчливом : ["и"]
пьяных : ["слез"]
пяти : ["человек"]
пятишести : ["но","но и"]
пятишести но : ["и"]
пятнистые : ["простыни","простыни и"]
пятнистые простыни : ["и"]
пятого : ["в","в десятое"]
пятого в : ["десятое"]
пятое : ["лицо","лицо местный"]
пятое лицо : ["местный"]
пятьдесят : ["копеек","копеек и"]
пятьдесят копеек : ["и"]
равнодушной : ["готовностью","готовностью с"]
равнодушной готовностью : ["с"]
равноправии : ["и","и сыщики"]
равноправии и : ["сыщики"]
рада : ["волнению","волнению и"]
рада волнению : ["и"]
ради : ["бога","бога мадам"]
ради бога : ["мадам"]
радостно : ["горит","горит в"]
радостно горит : ["в"]
разбитные : ["солдатки","солдатки и"]
разбитные солдатки : ["и"]
разбитые : ["щербатые","щербатые клавиши"]
разбитые щербатые : ["клавиши"]
разбрелось : []
разбросали : ["ее","ее длинную"]
разбросали ее : ["длинную"]
развалинах : ["тех","тех старинных"]
развалинах тех : ["старинных"]
развеселом : ["пьяном","пьяном драчливом"]
развеселом пьяном : ["драчливом"]
разводя : ["руками","руками и"]
разводя руками : ["и"]
разврат : ["нравственность","нравственность падает"]
разврат нравственность : ["падает"]
развратники : ["истрепанные","истрепанные всеми"]
развратники истрепанные : ["всеми"]
разговаривать : ["не","не хочет"]
разговаривать не : ["хочет"]
разделены : ["тонкими","тонкими перегородками"]
разделены тонкими : ["перегородками"]
разминает : ["языком","языком по"]
разминает языком : ["по"]
разница : ["только","только в"]
разница только : ["в"]
разные : ["там","там студенты"]
разные там : ["студенты"]
разрешенные : ["начальством","начальством руководимые"]
разрешенные начальством : ["руководимые"]
разудалая : ["музыка","музыка колебался"]
разудалая музыка : ["колебался"]
разъехались : []
разыскивают : ["ее","ее через"]
разыскивают ее : ["через"]
рамах : ["с","с двумя"]
рамах с : ["двумя"]
ранним : ["утром","утром пока"]
ранним утром : ["пока"]
рано : ["встала","встала в"]
рано встала : ["в"]
раньше : ["румяные","служил","румяные разбитные","служил по"]
раньше румяные : ["разбитные"]
раньше служил : ["по"]
раскрашенными : ["при","при помощи"]
раскрашенными при : ["помощи"]
распалось : ["и","и разбрелось"]
распалось и : ["разбрелось"]
расписанные : ["швейцарскими","швейцарскими пейзажами"]
расписанные швейцарскими : ["пейзажами"]
расписку : ["что","что по"]
расписку что : ["по"]
расползаются : ["из","из комнаты"]
расползаются из : ["комнаты"]
распорядились : ["завтраком","завтраком для"]
распорядились завтраком : ["для"]
рассвету : ["Яма","Яма понемногу"]
рассвету Яма : ["понемногу"]
рассказывайте : ["вздыхает","вздыхает Анна"]
рассказывайте вздыхает : ["Анна"]
рассрочку : ["по","по векселю"]
рассрочку по : ["векселю"]
расставленных : ["вдоль","вдоль стен"]
расставленных вдоль : ["стен"]
растеряло : ["свои","свои буйные"]
растеряло свои : ["буйные"]
расчетливо : ["не","не меняя"]
расчетливо не : ["меняя"]
расширить : ["помещение"]
расширяется : ["грушей","грушей от"]
расширяется грушей : ["от"]
рваные : ["темные","темные от"]
рваные темные : ["от"]
ревностью : []
революционеры : ["и","и разные"]
революционеры и : ["разные"]
редко : ["приходится","приходится видеть"]
редко приходится : ["видеть"]
резной : ["в","в русском"]
резной в : ["русском"]
резными : ["наличниками","подъездами","наличниками петухами","подъездами висячие"]
резными наличниками : ["петухами"]
резными подъездами : ["висячие"]
ремесленники : ["и","и вообще"]
ремесленники и : ["вообще"]
ресторан : ["или","или на"]
ресторан или : ["на"]
рефлектора : ["лампы","лампы и"]
рефлектора лампы : ["и"]
риску : ["я","я здесь"]
риску я : ["здесь"]
род : ["ямщики","ямщики казенные"]
род ямщики : ["казенные"]
рода : ["в","в род"]
рода в : ["род"]
родители : ["разыскивают","разыскивают ее"]
родители разыскивают : ["ее"]
родителям : []
родную : ["дочь"]
розовые : ["фонари","фонари канаусовые"]
розовые фонари : ["канаусовые"]
розовым : ["цветом","цветом лица"]
розовым цветом : ["лица"]
ропетовском : ["стиле","стиле с"]
ропетовском стиле : ["с"]
роскоши : ["обстановки"]
ростом : ["но","но круглотолста"]
ростом но : ["круглотолста"]
рот : ["старческий","старческий с"]
рот старческий : ["с"]
роялей : ["доносится","доносится сквозь"]
роялей доносится : ["сквозь"]
рублевые : []
рубля : ["а","а за"]
рубля а : ["за"]
рубят : ["к","к обеду"]
рубят к : ["обеду"]
ругают : ["что","что ты"]
ругают что : ["ты"]
руками : ["некрасивая","и","некрасивая в","и щурясь"]
руками и : ["щурясь"]
руками некрасивая : ["в"]
руки : ["по","по усам"]
руки по : ["усам"]
руководимые : ["официальным","официальным надзором"]
руководимые официальным : ["надзором"]
румяные : ["разбитные","разбитные солдатки"]
румяные разбитные : ["солдатки"]
русском : ["стиле","стиле подъезд"]
русском стиле : ["подъезд"]
рыбачек : ["гимназисток","гимназисток и"]
рыбачек гимназисток : ["и"]
рыжая : ["борода","борода веером"]
рыжая борода : ["веером"]
рыжий : ["пес","пес с"]
рыжий пес : ["с"]
рюмочку : ["на","на дорожку"]
рюмочку на : ["дорожку"]
рядовых : ["барышень"]
с : ["лишком","коньками","белым","белой","золотом","коврами","примесью","лицами","полупровалившимися","улицы","громкими","зловонным","дряблыми","грубой","теми","заученными","однообразными","равнодушной","глухими","накрепко","хрустальной","олеографическими","двумя","зеркалами","жидкой","голыми","ней","удовольствием","длинной","притворной","отвисшей","жирным","хозяйкой","розовым","подобострастием","бенедиктином","жирными","холодной","публичных","лишком заведениях","коньками резными","белым выстроен","белой дорожкой","золотом стулья","коврами диванами","примесью алкогольных","лицами хранящими","полупровалившимися носами","громкими именами","зловонным дыханием","дряблыми отвислыми","грубой поспешностью","теми же","заученными профессиональными","однообразными словами","равнодушной готовностью","глухими ставнями","накрепко закрытыми","хрустальной люстрой","олеографическими картинами","двумя десятками","зеркалами в","жидкой умирающей","голыми руками","ней никто","удовольствием помогла","длинной блестящей","притворной строгостью","отвисшей бессильно","жирным зобом","хозяйкой и","розовым цветом","жирными топлеными","холодной уверенностью","публичных домов»"]
с белой : ["дорожкой"]
с белым : ["выстроен"]
с глухими : ["ставнями"]
с голыми : ["руками"]
с громкими : ["именами"]
с грубой : ["поспешностью"]
с двумя : ["десятками"]
с длинной : ["блестящей"]
с дряблыми : ["отвислыми"]
с жидкой : ["умирающей"]
с жирным : ["зобом"]
с жирными : ["топлеными"]
с заученными : ["профессиональными"]
с зеркалами : ["в"]
с зловонным : ["дыханием"]
с золотом : ["стулья"]
с коврами : ["диванами"]
с коньками : ["резными"]
с лицами : ["хранящими"]
с лишком : ["заведениях"]
с накрепко : ["закрытыми"]
с ней : ["никто"]
с однообразными : ["словами"]
с олеографическими : ["картинами"]
с отвисшей : ["бессильно"]
с полупровалившимися : ["носами"]
с примесью : ["алкогольных"]
с притворной : ["строгостью"]
с публичных : ["домов»"]
с равнодушной : ["готовностью"]
с розовым : ["цветом"]
с теми : ["же"]
с удовольствием : ["помогла"]
с хозяйкой : ["и"]
с холодной : ["уверенностью"]
с хрустальной : ["люстрой"]
сами : ["мадам","мадам Шойбес"]
сами мадам : ["Шойбес"]
самих : ["себя"]
само : ["собою","собою случилось"]
само собою : ["случилось"]
самого : ["утра","утра сотни"]
самого утра : ["сотни"]
самое : ["великое","великое и"]
самое великое : ["и"]
самой : ["дальней","дальней окраине"]
самой дальней : ["окраине"]
самоучкой : ["чтобы","чтобы быть"]
самоучкой чтобы : ["быть"]
самый : ["деловой","деловой тихий"]
самый деловой : ["тихий"]
сбитых : ["сенников","сенников валяются"]
сбитых сенников : ["валяются"]
свежая : ["телом","телом вышла"]
свежая телом : ["вышла"]
сверканье : ["многогранного","многогранного рефлектора"]
сверканье многогранного : ["рефлектора"]
сверкающему : ["солнечному","солнечному дню"]
сверкающему солнечному : ["дню"]
сверх : ["сбитых","сбитых сенников"]
сверх сбитых : ["сенников"]
светлое : ["утро","утро застает"]
светлое утро : ["застает"]
светом : ["из","из окон"]
светом из : ["окон"]
светятся : ["желтые","желтые старые"]
светятся желтые : ["старые"]
свиданья : []
свободно : ["и","и просто"]
свободно и : ["просто"]
свободной : ["любовью","любовью постепенно"]
свободной любовью : ["постепенно"]
свое : ["удовольствие","удовольствие иметь"]
свое удовольствие : ["иметь"]
своей : ["очереди","минутной","требовательной","страшной","пестрой","очереди в","минутной власти","требовательной любовью","страшной физической","пестрой жизни"]
своей минутной : ["власти"]
своей очереди : ["в"]
своей пестрой : ["жизни"]
своей страшной : ["физической"]
своей требовательной : ["любовью"]
своем : ["прошлом","прошлом как"]
своем прошлом : ["как"]
свои : ["буйные","блеклые","буйные замашки","блеклые глаза"]
свои блеклые : ["глаза"]
свои буйные : ["замашки"]
своим : ["черным","черным изогнутым"]
своим черным : ["изогнутым"]
своими : ["оскверненными","оскверненными за"]
своими оскверненными : ["за"]
своих : ["публичных","жертвах","любовниках","обязанностях","публичных гаремах","жертвах так","обязанностях и"]
своих жертвах : ["так"]
своих обязанностях : ["и"]
своих публичных : ["гаремах"]
свою : ["нижнюю","нижнюю малиновую"]
свою нижнюю : ["малиновую"]
сдобные : ["ямские","ямские вдовы"]
сдобные ямские : ["вдовы"]
себе : ["представить","другого","представить вообразив","другого сына»"]
себе другого : ["сына»"]
себе представить : ["вообразив"]
себя : ["полрюмки","полрюмки ликера"]
себя полрюмки : ["ликера"]
сего : ["времени","времени осталась"]
сего времени : ["осталась"]
седенький : ["тихонький","тихонький молчаливый"]
седенький тихонький : ["молчаливый"]
семейной : ["чести","чести четыреста"]
семейной чести : ["четыреста"]
семейств : ["почтенные","почтенные столпы"]
семейств почтенные : ["столпы"]
семействе : []
семидесятилетней : ["старухе","старухе а"]
семидесятилетней старухе : ["а"]
семьей : ["жертвы","жертвы общественного"]
семьей жертвы : ["общественного"]
сеней : ["расписанные","расписанные швейцарскими"]
сеней расписанные : ["швейцарскими"]
сенников : ["валяются","валяются скомканные"]
сенников валяются : ["скомканные"]
серый : ["и","и где"]
серый и : ["где"]
сидят : ["курят","курят пьют"]
сидят курят : ["пьют"]
силе : ["и","и жестокости"]
силе и : ["жестокости"]
синий : ["табачный","табачный дым"]
синий табачный : ["дым"]
ситцевое : ["тряпье","тряпье или"]
ситцевое тряпье : ["или"]
сияла : ["снаружи","снаружи красными"]
сияла снаружи : ["красными"]
скажите : ["ради","ради бога"]
скажите ради : ["бога"]
сказать : []
скачет : ["на","на девушку"]
скачет на : ["девушку"]
сквозь : ["стекла","них","стекла беспрерывно","них видны"]
сквозь них : ["видны"]
сквозь стекла : ["беспрерывно"]
склоненной : ["набок","набок головой"]
склоненной набок : ["головой"]
скомканные : ["коекак","коекак рваные"]
скомканные коекак : ["рваные"]
скрипке : ["и","и теперь"]
скрипке и : ["теперь"]
скрипок : ["и","и роялей"]
скрипок и : ["роялей"]
скудно : []
скулит : ["и","и чихает"]
скулит и : ["чихает"]
слабо : ["светятся","светятся желтые"]
слабо светятся : ["желтые"]
слава : ["как","как о"]
слава как : ["о"]
сладко : ["выспалась","выспалась одна"]
сладко выспалась : ["одна"]
сладострастия : ["оберегательницы","оберегательницы семейной"]
сладострастия оберегательницы : ["семейной"]
слегка : ["хриплый","разминает","хриплый приятный","разминает языком"]
слегка разминает : ["языком"]
слегка хриплый : ["приятный"]
след : ["находится","находится у"]
след находится : ["у"]
следовательно : ["и","и в"]
следовательно и : ["в"]
следующей : ["ночи"]
следы : ["вчерашних","вчерашних побоев"]
следы вчерашних : ["побоев"]
слез : []
слепые : ["безносые","безносые с"]
слепые безносые : ["с"]
сливками : ["околоточный","околоточный с"]
сливками околоточный : ["с"]
слободой : ["или","или просто"]
слободой или : ["просто"]
слова : ["и","и выражения"]
слова и : ["выражения"]
словами : ["улыбками","с","улыбками и","с заученными"]
словами с : ["заученными"]
словами улыбками : ["и"]
слово : ["сказать"]
словом : ["в","в дом"]
словом в : ["дом"]
слогом : []
служба : []
службу : []
служил : ["по","по сыскной"]
служил по : ["сыскной"]
служила : ["здесь","здесь экономкой"]
служила здесь : ["экономкой"]
служишь : ["на","на Ямской"]
служишь на : ["Ямской"]
случай : ["вмешивается","вмешивается суетливо"]
случай вмешивается : ["суетливо"]
случилось : ["что","что на"]
случилось что : ["на"]
слушала : ["околоточного","околоточного набожно"]
слушала околоточного : ["набожно"]
слюнявые : ["старцы","старцы ищущие"]
слюнявые старцы : ["ищущие"]
смеешь : []
смеют : ["этого","этого делать"]
смеют этого : ["делать"]
смутным : ["воспоминаниям","воспоминаниям детства"]
смутным воспоминаниям : ["детства"]
снаружи : ["красными","белые","красными фонарями","белые тонкие"]
снаружи белые : ["тонкие"]
снаружи красными : ["фонарями"]
снизу : ["вверх","вверх три"]
снизу вверх : ["три"]
со : ["странным","всеми","мной","странным очарованием","всеми правами","мной разговаривать"]
со всеми : ["правами"]
со мной : ["разговаривать"]
со странным : ["очарованием"]
собакой : ["и","и тому"]
собакой и : ["тому"]
собаку : ["Амура"]
собою : ["случилось","случилось что"]
собою случилось : ["что"]
собственно : ["не","не пьет"]
собственно не : ["пьет"]
собственноручно : ["бьет","бьет бьет"]
собственноручно бьет : ["бьет"]
совершают : ["бесцельно","бесцельно самое"]
совершают бесцельно : ["самое"]
совершеннолетние : ["подтверждает","подтверждает Исай"]
совершеннолетние подтверждает : ["Исай"]
совершеннолетняя : ["говорит","говорит хозяйка"]
совершеннолетняя говорит : ["хозяйка"]
совести : ["несколько","при","несколько темных","при воспоминании"]
совести несколько : ["темных"]
совести при : ["воспоминании"]
совет : ["вам"]
совращенной : ["девушке","девушке более"]
совращенной девушке : ["более"]
совсем : ["другую","уж","одна","другую фамилию","уж грязно","одна на"]
совсем другую : ["фамилию"]
совсем одна : ["на"]
совсем уж : ["грязно"]
соглашается : ["околоточный"]
солдатки : ["и","и чернобровые"]
солдатки и : ["чернобровые"]
солдаты : ["мелкие","мелкие воришки"]
солдаты мелкие : ["воришки"]
солнечному : ["дню","дню который"]
солнечному дню : ["который"]
солнца : []
сон : ["с","с накрепко"]
сон с : ["накрепко"]
сонно : ["во","во всем"]
сонно во : ["всем"]
сонные : ["глаза","глаза и"]
сонные глаза : ["и"]
сорока : ["шести","шести с"]
сорока шести : ["с"]
сорочке : ["с","с голыми"]
сорочке с : ["голыми"]
состоит : ["гласным","гласным городской"]
состоит гласным : ["городской"]
сотни : ["и","и тысячи"]
сотни и : ["тысячи"]
социалдемократы : ["и","и анархисты"]
социалдемократы и : ["анархисты"]
спальни : ["точно","точно стойла"]
спальни точно : ["стойла"]
спальнях : ["голубые","голубые и"]
спальнях голубые : ["и"]
спиной : ["и","и хвостом"]
спиной и : ["хвостом"]
спит : ["и","и в"]
спит и : ["в"]
сплавьте : ["куданибудь","куданибудь заблаговременно"]
сплавьте куданибудь : ["заблаговременно"]
сплошь : ["и","и по"]
сплошь и : ["по"]
спокойновластное : []
спокойного : ["выражения","выражения лица"]
спокойного выражения : ["лица"]
спрашивает : ["искательно","искательно хозяйка"]
спрашивает искательно : ["хозяйка"]
спрашиваю : ["чего","чего хотят"]
спрашиваю чего : ["хотят"]
спускаются : ["по","по этим"]
спускаются по : ["этим"]
спущены : ["все","все гардины"]
спущены все : ["гардины"]
спят : ["купили","купили на"]
спят купили : ["на"]
сравнительной : ["нарядности","нарядности костюмов"]
сравнительной нарядности : ["костюмов"]
среди : ["дня","дня в"]
среди дня : ["в"]
средний : ["и","и маленький"]
средний и : ["маленький"]
срубленными : ["березками"]
ставнями : ["на","на окнах"]
ставнями на : ["окнах"]
стали : ["вырастать","вырастать открытые"]
стали вырастать : ["открытые"]
старая : ["фирма"]
старинные : ["бретеры","бретеры не"]
старинные бретеры : ["не"]
старинных : ["насиженных","насиженных гнезд"]
старинных насиженных : ["гнезд"]
старичок : []
старухе : ["а","а в"]
старухе а : ["в"]
старцы : ["ищущие","ищущие искусственных"]
старцы ищущие : ["искусственных"]
старческий : ["с","с отвисшей"]
старческий с : ["отвисшей"]
старшая : ["и","и младшая"]
старшая и : ["младшая"]
старые : ["развратники","изъеденные","развратники истрепанные","изъеденные временем"]
старые изъеденные : ["временем"]
старые развратники : ["истрепанные"]
статей : ["о","о женском"]
статей о : ["женском"]
стволики : ["с","с жидкой"]
стволики с : ["жидкой"]
стекла : ["беспрерывно","беспрерывно подъезжают"]
стекла беспрерывно : ["подъезжают"]
стемнеет : ["зажигаются","зажигаются перед"]
стемнеет зажигаются : ["перед"]
стен : ["белые","с","белые с","с олеографическими"]
стен белые : ["с"]
стен с : ["олеографическими"]
стены : ["сеней","сеней расписанные"]
стены сеней : ["расписанные"]
стерва : ["обманщица"]
стиле : ["с","подъезд","с коньками","подъезд двумя"]
стиле подъезд : ["двумя"]
стиле с : ["коньками"]
стоит : []
стойла : ["разделены","разделены тонкими"]
стойла разделены : ["тонкими"]
стол : ["разводя","разводя руками"]
стол разводя : ["руками"]
столетия : ["обе","обе улицы"]
столетия обе : ["улицы"]
столом : ["подслеповатый","подслеповатый Исай"]
столом подслеповатый : ["Исай"]
столпы : ["общества","общества в"]
столпы общества : ["в"]
столы : []
сторону : ["исключительно","дверей","исключительно домами"]
сторону исключительно : ["домами"]
сторублевой : []
странной : ["неправдоподобной","неправдоподобной жизнью"]
странной неправдоподобной : ["жизнью"]
страннопечальной : []
странным : ["очарованием","очарованием примешивается"]
странным очарованием : ["примешивается"]
страстной : ["недели","недели и"]
страстной недели : ["и"]
страстных : ["статей","статей о"]
страстных статей : ["о"]
страшной : ["физической","физической силе"]
страшной физической : ["силе"]
стриженая : ["девка","девка косы"]
стриженая девка : ["косы"]
строгие : ["блюстители","блюстители нравственности"]
строгие блюстители : ["нравственности"]
строго : ["подобранные","обрывает","подобранные губы","обрывает ее"]
строго обрывает : ["ее"]
строго подобранные : ["губы"]
строгой : ["страннопечальной"]
строгостью : []
студенистых : ["шара","шара большой"]
студенистых шара : ["большой"]
студенты : ["и","или","и социалдемократы"]
студенты и : ["социалдемократы"]
стульев : ["чинно","чинно расставленных"]
стульев чинно : ["расставленных"]
стулья : ["и","и зеркала"]
стулья и : ["зеркала"]
стучат : []
суда : []
судорожно : ["притворяются","притворяются веселыми"]
судорожно притворяются : ["веселыми"]
суетливо : ["Зося"]
суровым : ["правилам"]
сын : ["гимназист","ищи","гимназист Павел","ищи себе"]
сын гимназист : ["Павел"]
сын ищи : ["себе"]
сына» : []
сыростью : ["большой","большой нежилой"]
сыростью большой : ["нежилой"]
сыскной : ["части","части и"]
сыскной части : ["и"]
сыщики : ["и","и шпионы"]
сыщики и : ["шпионы"]
табаком : ["кислой","кислой сыростью"]
табаком кислой : ["сыростью"]
табачный : ["дым","дым носились"]
табачный дым : ["носились"]
таинств : ["таинство","таинство зарождения"]
таинств таинство : ["зарождения"]
таинство : ["зарождения","зарождения новой"]
таинство зарождения : ["новой"]
тайна : ["что","что через"]
тайна что : ["через"]
тайно : ["торговали","торговали водкой"]
тайно торговали : ["водкой"]
так : ["без","особенно","редко","и","без конца","особенно нелюдимо","редко приходится","и эти"]
так без : ["конца"]
так и : ["эти"]
так особенно : ["нелюдимо"]
так редко : ["приходится"]
также : ["траурный","траурный марш"]
также траурный : ["марш"]
такие : ["слова","слова и"]
такие слова : ["и"]
там : ["студенты","взять","студенты или","взять деньги"]
там взять : ["деньги"]
там студенты : ["или"]
танцевальном : ["зале","зале паркет"]
танцевальном зале : ["паркет"]
танцуют : ["выделывая","выделывая гнусные"]
танцуют выделывая : ["гнусные"]
танцы : ["а","а также"]
танцы а : ["также"]
театрах : ["манежах","манежах и"]
театрах манежах : ["и"]
тебе : ["дам","больше","больше не"]
тебе больше : ["не"]
тела : ["предшественника","пудрой","предшественника совершают","пудрой борнотимоловым"]
тела предшественника : ["совершают"]
тела пудрой : ["борнотимоловым"]
телами : ["с","с зловонным"]
телами с : ["зловонным"]
телодвижения : ["имитирующие","имитирующие акт"]
телодвижения имитирующие : ["акт"]
телом : ["вышла","вышла во"]
телом вышла : ["во"]
теми : ["же","же словами"]
теми же : ["словами"]
темная : ["слава","слава как"]
темная слава : ["как"]
темно : ["прохладно","прохладно и"]
темно прохладно : ["и"]
темное : ["и","и кровавое"]
темное и : ["кровавое"]
темные : ["от","от времени"]
темные от : ["времени"]
темных : ["дел"]
темперамента : ["клоаки","клоаки для"]
темперамента клоаки : ["для"]
теперь : ["по","по вечерам"]
теперь по : ["вечерам"]
терзает : ["своей","своей требовательной"]
терзает своей : ["требовательной"]
терпимости : ["выражаясь","выражаясь высоким"]
терпимости выражаясь : ["высоким"]
тех : ["старинных","старинных насиженных"]
тех старинных : ["насиженных"]
тихий : ["будничный","будничный час"]
тихий будничный : ["час"]
тихонький : ["молчаливый","молчаливый старичок"]
тихонький молчаливый : ["старичок"]
тишине : ["и","и полумраке"]
тишине и : ["полумраке"]
то : ["весь","скачет","стерва","весь волнуясь","скачет на","стерва обманщица"]
то весь : ["волнуясь"]
то скачет : ["на"]
то стерва : ["обманщица"]
того : ["неприятностей","неприятностей не"]
того неприятностей : ["не"]
тоже : ["спит","маленький","видели","спит и","маленький седенький","видели коечто"]
тоже видели : ["коечто"]
тоже маленький : ["седенький"]
тоже спит : ["и"]
толстую : ["траву","траву повсюду"]
толстую траву : ["повсюду"]
толстый : ["человек"]
толстых : ["комиков"]
только : ["в","на","шесть","что","делает","слово","идем","и","им","в плате","на дворе","шесть временных","что выбилась","делает вид","слово сказать","и думают","им свое"]
только в : ["плате"]
только делает : ["вид"]
только и : ["думают"]
только им : ["свое"]
только на : ["дворе"]
только слово : ["сказать"]
только что : ["выбилась"]
только шесть : ["временных"]
тому : ["что","назад","как","что выспалась","назад он","как старинные"]
тому как : ["старинные"]
тому назад : ["он"]
тому что : ["выспалась"]
тонкие : ["стволики","стволики с"]
тонкие стволики : ["с"]
тонкий : ["слегка","слегка хриплый"]
тонкий слегка : ["хриплый"]
тонкими : ["перегородками","перегородками не"]
тонкими перегородками : ["не"]
топлеными : ["сливками","сливками околоточный"]
топлеными сливками : ["околоточный"]
торговали : ["водкой","водкой и"]
торговали водкой : ["и"]
торжественно : ["и","и радостно"]
торжественно и : ["радостно"]
торопясь : ["кофеем","кофеем и"]
торопясь кофеем : ["и"]
торс : ["и","и голова"]
торс и : ["голова"]
тотчас : ["же","же после"]
тотчас же : ["после"]
точно : ["стойла","праздник","стойла разделены","праздник пасха"]
точно праздник : ["пасха"]
точно стойла : ["разделены"]
траву : ["повсюду"]
травы : []
традиции : ["не","не смеют"]
традиции не : ["смеют"]
трактиры : ["портерные","портерные и"]
трактиры портерные : ["и"]
траурный : ["марш","марш для"]
траурный марш : ["для"]
требовательной : ["любовью","любовью и"]
требовательной любовью : ["и"]
третьего : ["четвертого","дня","четвертого десятого","дня случай"]
третьего дня : ["случай"]
третьего четвертого : ["десятого"]
трех : ["последних","подбородков","последних дней"]
трех последних : ["дней"]
три : ["рубля","мягких","рубля а","мягких студенистых"]
три мягких : ["студенистых"]
три рубля : ["а"]
тридцати : ["с","с лишком"]
тридцати с : ["лишком"]
троица : []
троице : ["по","по смутным"]
троице по : ["смутным"]
тряпье : ["или","или в"]
тряпье или : ["в"]
трясущиеся : ["покрытые","покрытые паразитами"]
трясущиеся покрытые : ["паразитами"]
ту : ["и","же","пору","сторону","и по","же ночь","пору когда","сторону дверей"]
ту же : ["ночь"]
ту и : ["по"]
ту пору : ["когда"]
ту сторону : ["дверей"]
туго : ["натягивая","натягивая цепь"]
туго натягивая : ["цепь"]
тут : ["взятки"]
туфлями : ["к","к дверям"]
туфлями к : ["дверям"]
ты : ["болван","полицейский","полицейский и"]
ты полицейский : ["и"]
тысячи : ["мужчин","мужчин подымаются"]
тысячи мужчин : ["подымаются"]
тычется : ["над","над столом"]
тычется над : ["столом"]
тюль : ["вдоль","вдоль стен"]
тюль вдоль : ["стен"]
тяга : ["убила","убила конный"]
тяга убила : ["конный"]
тяжелее : ["чем","чем побои"]
тяжелее чем : ["побои"]
тяжелые : ["занавеси","занавеси и"]
тяжелые занавеси : ["и"]
у : ["нее","жены","него","вас","меня","нас","нее блеклоголубые","жены под","нее окружены","нее всегда","него рыжая","вас и","меня сын","меня тоже","нас был"]
у вас : ["и"]
у жены : ["под"]
у меня : ["сын","тоже"]
у нас : ["был"]
у него : ["рыжая"]
у нее : ["блеклоголубые","окружены","всегда"]
убийцы : ["и","и либеральные"]
убийцы и : ["либеральные"]
убила : ["конный","конный извоз"]
убила конный : ["извоз"]
уважения : ["к","к родителям"]
уважения к : ["родителям"]
уверенностью : []
увядающей : ["болотной","болотной травы"]
увядающей болотной : ["травы"]
угрызений : ["совести","совести при"]
угрызений совести : ["при"]
удалось : ["замять","замять это"]
удалось замять : ["это"]
удалясь : ["на","на покой"]
удалясь на : ["покой"]
удовлетворяют : ["как","как машины"]
удовлетворяют как : ["машины"]
удовольствие : ["иметь"]
удовольствием : ["помогла","помогла кухарке"]
удовольствием помогла : ["кухарке"]
удушья : ["то","то весь"]
удушья то : ["весь"]
уезжают : ["извозчики"]
уж : ["грязно","грязно и"]
уж грязно : ["и"]
уже : ["ждущего","разъехались","ждущего своей"]
уже ждущего : ["своей"]
узкий : ["коридор","коридор вверху"]
узкий коридор : ["вверху"]
украсил : ["резной","резной в"]
украсил резной : ["в"]
улица : ["сияла","пуста","сияла снаружи"]
улица сияла : ["снаружи"]
улице : ["точно","точно праздник"]
улице точно : ["праздник"]
улицы : ["Ямы","Ямы Большая"]
улицы Ямы : ["Большая"]
улыбается : ["скулит","скулит и"]
улыбается скулит : ["и"]
улыбками : ["и","и жестами"]
улыбками и : ["жестами"]
умирающей : ["зеленью"]
управы : []
уроды : ["злобно","злобно исковерканные"]
уроды злобно : ["исковерканные"]
усам : ["вправо","вправо и"]
усам вправо : ["и"]
утра : ["сотни","людьми","сотни и","людьми и"]
утра людьми : ["и"]
утра сотни : ["и"]
утро : ["застает","застает ее"]
утро застает : ["ее"]
утром : ["пока","пока их"]
утром пока : ["их"]
уходит : []
ученики : ["ругают","ругают что"]
ученики ругают : ["что"]
ушел : []
фаворитка : ["которую","которую она"]
фаворитка которую : ["она"]
фамилию : ["и","и состоит"]
фамилию и : ["состоит"]
фамильярно : ["«экономочкой»"]
фантастической : ["ревностью"]
физической : ["силе","силе и"]
физической силе : ["и"]
фирма : []
фонари : ["канаусовые","канаусовые одеяла"]
фонари канаусовые : ["одеяла"]
фонарями : ["над","над подъездами"]
фонарями над : ["подъездами"]
фортепиано : ["своим","своим черным"]
фортепиано своим : ["черным"]
фыркает : ["носом","носом и"]
фыркает носом : ["и"]
хвостом : ["пригибает","пригибает голову"]
хвостом пригибает : ["голову"]
хлопает : ["за","за ним"]
хлопает за : ["ним"]
хозяйка : ["на","на чье"]
хозяйка на : ["чье"]
хозяйки : ["пьют","пьют кофе"]
хозяйки пьют : ["кофе"]
хозяйкой : ["и","и побаиваются"]
хозяйкой и : ["побаиваются"]
холодно : ["и","и расчетливо"]
холодно и : ["расчетливо"]
холодной : ["уверенностью"]
хорошего : ["Исай","Исай Саввич"]
хорошего Исай : ["Саввич"]
хороший : ["знакомый","знакомый предупреждаюс"]
хороший знакомый : ["предупреждаюс"]
хотим : ["немножко","немножко расширить"]
хотим немножко : ["расширить"]
хотят : ["добиться","добиться эти"]
хотят добиться : ["эти"]
хочет : []
хранит : ["вчерашний","вчерашний запах"]
хранит вчерашний : ["запах"]
хранящими : ["следы","следы вчерашних"]
хранящими следы : ["вчерашних"]
храпя : ["от","от удушья"]
храпя от : ["удушья"]
хриплы : ["или","или гнусавы"]
хриплы или : ["гнусавы"]
хриплый : ["приятный","приятный голос"]
хриплый приятный : ["голос"]
хрустальной : ["люстрой","люстрой посредине"]
хрустальной люстрой : ["посредине"]
хрустит : ["в","в кармане"]
хрустит в : ["кармане"]
хрустящую : ["под","под ногами"]
хрустящую под : ["ногами"]
худощава : ["вертлява","вертлява чуть"]
худощава вертлява : ["чуть"]
хуже : ["обставлены"]
царапин : ["и","и наивно"]
царапин и : ["наивно"]
цвета : []
цветное : ["ситцевое","ситцевое тряпье"]
цветное ситцевое : ["тряпье"]
цветом : ["лица","лица и"]
цветом лица : ["и"]
целый : ["воз","воз осоки"]
целый воз : ["осоки"]
цепную : ["собаку","собаку Амура"]
цепную собаку : ["Амура"]
цепь : ["и","и храпя"]
цепь и : ["храпя"]
чадный : ["с","с примесью"]
чадный с : ["примесью"]
час : []
часа : ["дня"]
часов : ["и","и с"]
часов и : ["с"]
части : ["хриплы","и","хриплы или","и был"]
части и : ["был"]
части хриплы : ["или"]
часть : ["в","получит","в рассрочку","получит наличными"]
часть в : ["рассрочку"]
часть получит : ["наличными"]
чего : ["хотят","хотят добиться"]
чего хотят : ["добиться"]
человек : []
человека : ["нельзя","нельзя положиться"]
человека нельзя : ["положиться"]
человеческих : ["извержений"]
чем : ["побои"]
чемнибудь : ["полезным","полезным выучился"]
чемнибудь полезным : ["выучился"]
через : ["два","год","полицию","два Анна","год через"]
через год : ["через"]
через два : ["Анна"]
чернобровые : ["сдобные","сдобные ямские"]
чернобровые сдобные : ["ямские"]
черной : ["мордой","мордой то"]
черной мордой : ["то"]
черные : []
черным : ["изогнутым","изогнутым глянцевитым"]
черным изогнутым : ["глянцевитым"]
черными : ["геморроидальными","геморроидальными кругами"]
черными геморроидальными : ["кругами"]
чести : ["четыреста","четыреста глупых"]
чести четыреста : ["глупых"]
честь : []
четверо : ["тоже","тоже видели"]
четверо тоже : ["видели"]
четвертого : ["десятого","десятого мужчину"]
четвертого десятого : ["мужчину"]
четыреста : ["глупых","глупых ленивых"]
четыреста глупых : ["ленивых"]
чинно : ["расставленных","расставленных вдоль"]
чинно расставленных : ["вдоль"]
число : []
чистые : ["подушки"]
чихает : ["от","от возбуждения"]
чихает от : ["возбуждения"]
членом : ["управы"]
что : ["на","никогда","выспалась","через","выбилась","он","два","делает","по","берешь","служишь","ты","я","о","на развалинах","никогда не","выспалась и","через год","выбилась из","он раньше","два года","делает одолжение","по доброй","берешь взятки","служишь на","ты полицейский","я прямо","о своих"]
что берешь : ["взятки"]
что выбилась : ["из"]
что выспалась : ["и"]
что два : ["года"]
что делает : ["одолжение"]
что на : ["развалинах"]
что никогда : ["не"]
что о : ["своих"]
что он : ["раньше"]
что по : ["доброй"]
что служишь : ["на"]
что ты : ["полицейский"]
что через : ["год"]
что я : ["прямо"]
чтобы : ["тотчас","быть","этого","тотчас же","быть чемнибудь","этого больше"]
чтобы быть : ["чемнибудь"]
чтобы тотчас : ["же"]
чтобы этого : ["больше"]
чтут : ["ее","ее наравне"]
чтут ее : ["наравне"]
чувствовали : ["никаких","никаких угрызений"]
чувствовали никаких : ["угрызений"]
чуть : ["косенькая","косенькая с"]
чуть косенькая : ["с"]
чучело : ["медведя","медведя держащее"]
чучело медведя : ["держащее"]
чье : ["имя","имя записан"]
чье имя : ["записан"]
шаги : ["затихают","затихают на"]
шаги затихают : ["на"]
шара : ["большой","большой средний"]
шара большой : ["средний"]
шаркает : ["туфлями","туфлями к"]
шаркает туфлями : ["к"]
шатенка : ["лет","лет сорока"]
шатенка лет : ["сорока"]
шатровыми : ["резными","резными подъездами"]
шатровыми резными : ["подъездами"]
шашку : []
швейцаром : ["в","в этом"]
швейцаром в : ["этом"]
швейцарскими : ["пейзажами"]
шелковые : ["тяжелые","тяжелые занавеси"]
шелковые тяжелые : ["занавеси"]
шерстью : ["и","и черной"]
шерстью и : ["черной"]
шести : ["с","с жирным"]
шести с : ["жирным"]
шесть : ["временных","временных гостей"]
шесть временных : ["гостей"]
шестьдесят : []
шикарное : ["заведение","заведение Треппеля"]
шикарное заведение : ["Треппеля"]
широкой : ["постели"]
шпионы : ["и","и беглые"]
шпионы и : ["беглые"]
щекам : ["и","и землистого"]
щекам и : ["землистого"]
щербатые : ["клавиши"]
щурясь : ["подумайте","подумайте какому"]
щурясь подумайте : ["какому"]
экипажами : []
экономки : ["старшая","старшая и"]
экономки старшая : ["и"]
экономкой : []
эта : ["местность","местность называлась"]
эта местность : ["называлась"]
эти : ["люди","революционеры","люди глядят","революционеры и"]
эти люди : ["глядят"]
эти революционеры : ["и"]
этим : ["лестницам","запахам","запахам запах"]
этим запахам : ["запах"]
это : ["ее","гораздо","дело","служба","же","ее юбка","гораздо тяжелее","же не"]
это гораздо : ["тяжелее"]
это ее : ["юбка"]
это же : ["не"]
этого : ["делать","больше","делать своими","больше не"]
этого больше : ["не"]
этого делать : ["своими"]
этом : ["же","говорю","же доме","говорю досадливо"]
этом говорю : ["досадливо"]
этом же : ["доме"]
эту : ["девицу","девицу лучше"]
эту девицу : ["лучше"]
юбка : ["торс","торс и"]
юбка торс : ["и"]
южного : ["города","города жили"]
южного города : ["жили"]
я : ["здесь","могу","не","попрошу","ему","прямо","вас","здесь подвергаюсь","могу поделать","не об","попрошу вас","ему по","ему еще","прямо аж","вас понимаю"]
я вас : ["понимаю"]
я ему : ["по","еще"]
я здесь : ["подвергаюсь"]
я могу : ["поделать"]
я не : ["об"]
я попрошу : ["вас"]
я прямо : ["аж"]
языком : ["по","по нёбу"]
языком по : ["нёбу"]
яйца : ["не","не стоит"]
яйца не : ["стоит"]
ямские : ["вдовы","вдовы тайно"]
ямские вдовы : ["тайно"]
ямской : ["проституции"]
ямщики : ["казенные","казенные и"]
ямщики казенные : ["и"]
ямщичье : ["племя","племя понемногу"]
ямщичье племя : ["понемногу"]
ярко : ["освещены","освещены веселая"]
ярко освещены : ["веселая"]
яркосиние : ["сонные","сонные глаза"]
яркосиние сонные : ["глаза"]
ясноглазые : ["красавцы","красавцы и"]
ясноглазые красавцы : ["и"]
ёрническом : ["ропетовском","ропетовском стиле"]
ёрническом ропетовском : ["стиле"]
